Подшипник  NUMBER  ( NUMBER )	Подшипники
Винт  NUMBER х NUMBER  ГОСТ NUMBER - NUMBER (DIN  NUMBER )	Метизы
Пускатель ПМ ГОСТО  NUMBER - NUMBER - NUMBER   NUMBER В	Запчасти
Образец станд Ш NUMBER  концентрат плавико	РеактивыХимич.
Насос A NUMBER VG NUMBER EP NUMBER DT NUMBER / NUMBER R-PZD NUMBER F NUMBER LH-S	Насосы
Натрий хлористый	Химпродукция
Крестовина  NUMBER 	Запчасти
Фреза сборная MT NUMBER -S NUMBER N NUMBER SD NUMBER - NUMBER 	Фрезы
Ось  NUMBER . NUMBER . NUMBER . NUMBER . NUMBER  ЭСПЦ	З/Ч по чертежам
Пневмомассажер Лимфа-Э - NUMBER 	З/Ч Пневмооборудов
Модуль IM NUMBER - NUMBER PN  NUMBER ES NUMBER - NUMBER AA NUMBER - NUMBER XB NUMBER 	Запчасти
Круг  NUMBER  ст NUMBER 	ПрокатСортовойОбНазн
Датчик имп. Heidenhain ERN  NUMBER . NUMBER - NUMBER 	Запчасти
Резец проходной отогнутый  NUMBER х NUMBER  Т NUMBER К NUMBER 	Резцы
Картридж HP LJ  NUMBER  Q NUMBER A	Расходные материалы
'Головка с внеш шестигр  NUMBER / NUMBER ''  NUMBER мм USAG	Инструмент слесарный
Метчик м/р М NUMBER х NUMBER , NUMBER  компл  NUMBER ед	Инструмент режущий
Прибор пожарной сигнализации Сигнал- NUMBER П	ПриборыСистАвтоматик
Зенковка  NUMBER , NUMBER х NUMBER  град	Инструмент режущий
Петля дверная пр	Стройматериалы
ТхдОН ГОСТ NUMBER   NUMBER   NUMBER   NUMBER 	Трубы
Направляющая ч. NUMBER - NUMBER . NUMBER 	Запчасти
Уголок  NUMBER  ПП ф NUMBER 	Стройматериалы
Клапан  NUMBER WE NUMBER D NUMBER Х/EW NUMBER N NUMBER K NUMBER 	Запчасти
Оправка цилиндр М NUMBER . NUMBER . NUMBER . NUMBER . NUMBER - NUMBER 	Инструменты
Разъем D NUMBER . NUMBER mm AMASS	КонтрИзмеритПриборы
Сетка фильтр  NUMBER - NUMBER  центрифуги МТЗ	З/Ч ТракСтроитТехн
Втулка бронз В NUMBER  ТПЦ- NUMBER 	З/Ч по чертежам
Втулка  NUMBER L NUMBER . NUMBER  ТПЦ- NUMBER 	З/Ч по чертежам
Пластина тв спл CNMM  NUMBER -PR  NUMBER 	Сплав твердый
Муфта ч. NUMBER А	Запчасти
Образец станд ЭГР- NUMBER 	РеактивыХимич.
Колено полипропиленовое обводное Ф NUMBER 	ИздИзПолимеровСтанд
Червяк ч.Э- NUMBER - NUMBER 	Запчасти
Пруток бронзовый ф NUMBER  БРАЖ NUMBER - NUMBER 	Металлопрокат
Трос КПП без з/х  NUMBER - NUMBER К NUMBER HYUNDAI HD NUMBER 	З/Ч АвтомобПромышл
Шнур оптический SC-SC SM двойной  NUMBER м	Кабельно-проводников
Вал первичный КПП в сборе  NUMBER  КАМАЗ	З/Ч АвтомобПромышл
Угольник крепежный AF NUMBER P- NUMBER AS	З/Ч по чертежам
Соединение приварное V  NUMBER -S	Запчасти
Труба распылительная  NUMBER 	Запчасти
Наконечник кабельн медн ТМ- NUMBER мм NUMBER 	Изделия электроустан
Деталь нажимная ч. NUMBER 	Запчасти
Шланг возд. NUMBER TE DN NUMBER x NUMBER G½ K NUMBER - NUMBER - NUMBER 	Запчасти
Червяк  NUMBER L NUMBER . NUMBER  ТПЦ- NUMBER 	З/Ч по чертежам
Преобразователь П NUMBER - NUMBER , NUMBER - NUMBER ULTRA- NUMBER - NUMBER 	ДатчСистемАвтоматики
Круг шлиф  NUMBER х NUMBER х NUMBER   NUMBER А MED	Инструм. абразивный
ВыключательВА NUMBER - NUMBER М NUMBER - NUMBER - NUMBER А- NUMBER 	Запчасти
Заглушка полиэтиленовая ф NUMBER , NUMBER х NUMBER , NUMBER 	ИздДляТрубПредохран
Метчик м/р М NUMBER х NUMBER , NUMBER 	Инструмент режущий
Колесо крана  NUMBER L NUMBER . NUMBER Б- NUMBER  ТПЦ- NUMBER 	З/Ч ГрузПодъемОборуд
Рукав РВД  NUMBER - NUMBER , NUMBER  (М NUMBER х NUMBER , NUMBER )  NUMBER мм	ИзделияРезино-технич
Фреза шпоночная ц/х  NUMBER , NUMBER  ВК NUMBER 	Фрезы
Болт М NUMBER х NUMBER   NUMBER . NUMBER  ГОСТ NUMBER - NUMBER 	Метизы
Лампа ртутная ДРЛ- NUMBER  Е NUMBER 	Комплектующие электр
Манжета S NUMBER - NUMBER T  NUMBER х NUMBER х NUMBER  Ecopur	Запчасти
Строп стал канат УСК NUMBER - NUMBER , NUMBER / NUMBER 	Стропы
Фитинг С NUMBER  Norgren	З/Ч Пневмооборудов
Автомат NZMH NUMBER -VE NUMBER -S NUMBER   NUMBER   NUMBER А	ВыключатАвтоматич
Холодильник V от  NUMBER  л до  NUMBER 	ХозИнвентарь
Конденсатор К NUMBER - NUMBER   NUMBER в  NUMBER мкф	Конденсаторы
Кабель Olflex HEAT  NUMBER  EWKF  NUMBER G NUMBER . NUMBER 	Кабельная продукция
Бочка ролика ч.Р- NUMBER - NUMBER 	Запчасти
Уплотнение NB NUMBER - NUMBER / NUMBER  CAR/SIC/EPDM	Запчасти
Сверло спиральное ц/х  NUMBER , NUMBER 	Сверла
Клапан V NUMBER B NUMBER A-A NUMBER J  NUMBER VDC	Запчасти
Шплинт  NUMBER , NUMBER х NUMBER  ГОСТ NUMBER - NUMBER 	Метизы
Анод к АС- NUMBER /АС - NUMBER М  NUMBER М NUMBER . NUMBER . NUMBER 	Запчасти
Реле тепл Е  NUMBER   NUMBER А LRE NUMBER 	Реле
Манжета армиров  NUMBER х NUMBER х NUMBER , NUMBER  ГОСТ  NUMBER - NUMBER 	ИзделияРезино-технич
Ткань фильтрующая КР NUMBER / NUMBER / NUMBER 	Запчасти
Композит термост керамический ЖКО- NUMBER 	ОборуТехнологическое
Вал-шестерня ч. NUMBER - NUMBER 	Запчасти
Адаптер ч.Э- NUMBER - NUMBER 	Запчасти
Лента измерит рулетка РЗ- NUMBER м УЗК	Инструм. мерительный
Свеча зажиган СН  NUMBER - NUMBER  КАМАЗ  NUMBER 	З/Ч АвтомобПромышл
Реле времени АНЗ-NA ( NUMBER  сек.. NUMBER  мин)AC NUMBER 	Реле
Ключ гаечный рожковый  NUMBER х NUMBER 	Инструменты
Клапан  NUMBER WRKE NUMBER W NUMBER - NUMBER L- NUMBER X/ NUMBER EG NUMBER K NUMBER /F NUMBER D NUMBER M	З/Ч Гидрооборудован
Контактор LC NUMBER E NUMBER B NUMBER   NUMBER A КАТ  NUMBER B AC- NUMBER 	Контакторы
Золотник с обратным клапаном БПГ  NUMBER - NUMBER 	Запчасти
Блок контактов  NUMBER RH NUMBER - NUMBER HА  NUMBER  Siemens	Запчасти
Протектор с мет обеч ф NUMBER  TMK Centum	ИздДляТрубПредохран
Сверло спиральное к/х  NUMBER , NUMBER 	Сверла
Лебедка рычажн ручная ЛР  NUMBER , NUMBER / NUMBER 	КраныТельферыЛебедки
Флокулянт Праестол  NUMBER 	Издел.Асбесто-технич
Отвод  NUMBER - NUMBER х NUMBER  ст NUMBER 	Арматура к трубам
Гидроцил CDH NUMBER MF NUMBER / NUMBER / NUMBER / NUMBER A NUMBER X/B NUMBER CSDMWW	Запчасти
Сверло спиральное ц/х  NUMBER , NUMBER 	Сверла
Пластина резьбовая TMR  NUMBER L NUMBER - NUMBER - NUMBER 	Сплав твердый
Вал  NUMBER . NUMBER . NUMBER 	З/Ч по чертежам
Транзистор КТ NUMBER А	ДиодТранзисторТирист
Средство чистящее для кофемашин	Химпродукция
Мотор-ред АЕ NUMBER   NUMBER , NUMBER кВт,  NUMBER В, NUMBER Гц Velco	З/Ч по чертежам
Строп текст петл СТП- NUMBER / NUMBER 	Стропы
Оправка FI-MVK- NUMBER S-PRC-W NUMBER 	Инструмент слесарный
Смазка Best-o-Life API Modified	Смазки
Тройник полипропиленовый ф NUMBER 	ИздИзПолимеровСтанд
Электродвигатель  NUMBER / NUMBER H NUMBER  №  NUMBER 	Запчасти
Лампа накал автомоб А NUMBER - NUMBER  ВА NUMBER S/ NUMBER 	СветотехнИсточнСвета
Поковка ф NUMBER х NUMBER  ст NUMBER 	ПрокатСортовойОбНазн
Напильник трехгранный  NUMBER  № NUMBER 	Инструмент слесарный
Кирпич периклазоуглерод RI-MC NUMBER ECA  NUMBER / NUMBER 	Периклазоуглеродисты
Дозатор в сборе ZEM NUMBER СЕЕEEE	Запчасти
Монитор BenQ GL NUMBER PQ	ОборудПрочее
Клапан электрогидравлич  NUMBER  Scheuerle	З/Ч ТракСтроитТехн
Кулачок зажимной  NUMBER - NUMBER А ТПЦ- NUMBER 	Резцы
Модуль IGBT SKM NUMBER GАL NUMBER D Semikron	Запчасти
Толщиномер Константа К NUMBER  с ИД NUMBER Р- NUMBER шт	КонтрИзмеритПриборы
Датчик  NUMBER М-ДИ- NUMBER - NUMBER , NUMBER / NUMBER , NUMBER МПа- NUMBER -Л- NUMBER 	Запчасти
Датчик ВБИ-М NUMBER - NUMBER У- NUMBER -Л	Запчасти
Фитинг DFS  NUMBER S	З/Ч Пневмооборудов
Резец сборный S NUMBER W PCLNR  NUMBER 	Резцы
Гайка М NUMBER  ГОСТ NUMBER - NUMBER 	Метизы
Головка револьверная  NUMBER . NUMBER . NUMBER . NUMBER  SAUTER	Запчасти
Ремень полиуретановый  NUMBER -ATP NUMBER - NUMBER 	ИзделияРезино-технич
Пластина резьб  NUMBER . NUMBER  CTP NUMBER 	Инструменты
Цилиндр LS NUMBER ES  NUMBER / NUMBER - NUMBER /R NUMBER /F NUMBER 	Запчасти
Сверло спиральное ц/х  NUMBER , NUMBER 	Сверла
Насос консольн К- NUMBER - NUMBER - NUMBER а	Насосы
Блок лёточный RI-ТН NUMBER EC  NUMBER v NUMBER MB NUMBER 	Огнеупоры
Шланг PARKER  NUMBER LT- NUMBER 	Запчасти
Гайка М NUMBER  ГОСТ NUMBER - NUMBER 	Метизы
Пост ПКУ- NUMBER - NUMBER - NUMBER - NUMBER У NUMBER  № NUMBER 	КнопкиПостыУправлен
Полумуфта ч. NUMBER 	Запчасти
Набор ключей торцевых  NUMBER  Gedore	Инструмент слесарный
Шестерня  NUMBER . NUMBER L. NUMBER . NUMBER . NUMBER  ТПЦ- NUMBER 	З/Ч по чертежам
Шайба уплотнительная Ф  NUMBER  К- NUMBER 	З/Ч по чертежам
Блок питания для сервера Z NUMBER   NUMBER R NUMBER 	Блоки систем автомат
Датчик Метран  NUMBER CDR NUMBER ( NUMBER - NUMBER , NUMBER кгс/см²) NUMBER 	КонтрИзмеритПриборы
Винт  NUMBER х NUMBER  ГОСТ NUMBER - NUMBER (DIN  NUMBER )	Метизы
Втулка В NUMBER 	З/Ч по чертежам
Пластина резьбовая TN  NUMBER ER  NUMBER M  NUMBER 	Сплав твердый
Метчик трубный конический Rc  NUMBER   NUMBER / NUMBER 	Инструмент режущий
Плита теплоизоляционная МКРП- NUMBER 	Теплоизоляционные
Цилиндр сцеплен раб  NUMBER - NUMBER  ГАЗ  NUMBER 	З/Ч АвтомобПромышл
Устройство ЗП Охра- NUMBER 	Запчасти
Электродвигатель ZBA  NUMBER  B NUMBER  B NUMBER  H NUMBER  Demag	Запчасти
Винт  NUMBER х NUMBER   NUMBER . NUMBER . ГОСТ NUMBER - NUMBER  DIN NUMBER 	Метизы
Ось ч.Р- NUMBER 	Запчасти
Профиль монтажный К NUMBER  У NUMBER  L- NUMBER м	Изделия электроустан
Клапан  NUMBER L NUMBER . NUMBER  ТПЦ- NUMBER 	З/Ч по чертежам
Пленка для ламинирования А NUMBER 	МатерСтроительные
Рубильник ВР- NUMBER - NUMBER В NUMBER - NUMBER УХЛ NUMBER   NUMBER А	З/Ч по чертежам
Пластина резьбовая  NUMBER . NUMBER -C ASC NUMBER 	Сплав твердый
Обойма зубчатая ч.К- NUMBER 	Запчасти
Ключ разводной КР- NUMBER   NUMBER  Gedore	Инструмент слесарный
Зажим Каретка фланцевый ККIPP К NUMBER . NUMBER 	Изделия электроустан
Шуруп  NUMBER х NUMBER  ГОСТ NUMBER - NUMBER 	Метизы
Мундштук № NUMBER  РМ к резаку РМ  NUMBER 	З/Ч к компрессорам
Набор шпильковертов  NUMBER  Gedore	СИЗ (без размеров)
Зажим	З/Ч по чертежам
Стартер Н- NUMBER   NUMBER - NUMBER  для мотокос	Запчасти
Трубка ПВХ ф NUMBER 	Изделия электроустан
Манжета R NUMBER -R  NUMBER x NUMBER x NUMBER , NUMBER  Rub- NUMBER /Ecotal	Запчасти
Подшипник FAG  NUMBER / NUMBER -MPB	Подшипники
Шаблон ф NUMBER   NUMBER ФН ч.Э- NUMBER - NUMBER 	ОборудТехнолог
Метчик м/р М NUMBER х NUMBER , NUMBER  компл  NUMBER ед	Инструмент режущий
Уголок с гайкой VBDKO  NUMBER -S	Запчасти
Звено П-ПРД- NUMBER , NUMBER - NUMBER 	Цепи и звенья
Съемник трехлапый зажимной  NUMBER - NUMBER мм	Инструмент слесарный
Подшипник McGill CF  NUMBER  SB	Подшипники
Головка гл сверл  NUMBER - NUMBER D NUMBER  M NUMBER 	Сверла
Пластина тв спл опорная С NUMBER  GC NUMBER 	Сплав твердый
^Термометр контактный цифровой ТК- NUMBER . NUMBER 	КонтрИзмеритПриборы
Энкодер ARS NUMBER -F NUMBER A NUMBER  Sick	ДатчСистемАвтоматики
Насос  NUMBER  PVS  NUMBER . NUMBER  FHRM Berarma	Насосы
'Пара винтовая ШВП оси ''Z''  NUMBER  EMAG	З/Ч кМеталлообОборуд
Ключ шестигранный  NUMBER 	Инструмент слесарный
Тонер для копира Canon  NUMBER (C-EXV NUMBER )	Расходные материалы
Заглушка полиэтиленовая ф NUMBER х NUMBER 	ИздДляТрубПредохран
Диск тормозной  NUMBER - NUMBER  трактор МТЗ	З/Ч ТракСтроитТехн
Наконечник изолированный НкИш  NUMBER , NUMBER - NUMBER , NUMBER мм NUMBER 	Изделия электроустан
Переход К- NUMBER - NUMBER , NUMBER х NUMBER , NUMBER - NUMBER , NUMBER х NUMBER , NUMBER  ст NUMBER 	Арматура к трубам
Затвор поворотный хим ЗПХ Ду NUMBER  Ру NUMBER 	З/Ч к НасосВентилят
Лист стальной AISI  NUMBER г/к  NUMBER х NUMBER х NUMBER 	Трубы
Станция смазки  NUMBER - NUMBER - NUMBER - NUMBER 	Запчасти
Пластина тв спл CCMT  NUMBER -PM  NUMBER 	Сплав твердый
Подшипник  NUMBER  ( NUMBER   NUMBER RS)	Подшипники
Кальций хлористый	РеактивыХимич.
Гайка нержавеющая М NUMBER  DIN  NUMBER  А NUMBER  А NUMBER  А NUMBER 	Метизы
Лента EMAG B= NUMBER - NUMBER . NUMBER ,  NUMBER . NUMBER mm	Запчасти
Обойма зубчатая № NUMBER  ч.К- NUMBER 	Запчасти
Уплотнение шевронное М  NUMBER х NUMBER 	Запчасти
Лампа светодиодн коммут УПС NUMBER А	СветотехнИсточнСвета
Манжета уплотнения трубы ф NUMBER , NUMBER  ч. NUMBER 	Запчасти
Бур к перфоратору SDS MAX  NUMBER х NUMBER / NUMBER 	Сверла
Наделка ч. NUMBER - NUMBER . NUMBER 	Запчасти
Болт М NUMBER х NUMBER   NUMBER . NUMBER  ГОСТ NUMBER  DIN NUMBER , NUMBER 	Метизы
Подшипник АХК NUMBER х NUMBER х NUMBER / NUMBER - NUMBER 	Запчасти
Резец расточной R NUMBER . NUMBER - NUMBER - NUMBER АА	Резцы
Колесо поворот к столу гидр СПГ NUMBER , NUMBER / NUMBER 	З/Ч ГрузПодъемОборуд
Кирпич периклазоуглерод ПУ- NUMBER   NUMBER / NUMBER 	Периклазоуглеродисты
Шайба плоская  NUMBER  ГОСТ NUMBER - NUMBER 	Метизы
Станция смазочная  NUMBER - NUMBER 	Запчасти
Разъем SACC-M NUMBER MS NUMBER CONPG NUMBER   NUMBER PHOENIX	Изделия электроустан
Бетон CERALIT FLOW TR  NUMBER 	Огнеупоры
Полумуфта  NUMBER - NUMBER  ТПЦ- NUMBER 	З/Ч по чертежам
"Фитинг ввертной угл  NUMBER L  NUMBER / NUMBER "" WE NUMBER LR NUMBER / NUMBER CF"	Запчасти
Винт  NUMBER х NUMBER  ГОСТ NUMBER - NUMBER  (DIN NUMBER )	Метизы
Прибор фиксации OUT NUMBER X NUMBER  Telea	Запчасти
Лезвие для ножа Stayer трапец  NUMBER  мм	Инструмент слесарный
Винт  NUMBER х NUMBER  ГОСТ NUMBER - NUMBER (DIN  NUMBER )	Метизы
Клапан A NUMBER - NUMBER C NUMBER  A NUMBER   NUMBER - NUMBER 	Запчасти
Наконечник токопровод № NUMBER . NUMBER  ф NUMBER , NUMBER мм	Инструм. мерительный
Ступица перед с бараб  NUMBER - NUMBER  КАМАЗ	З/Ч АвтомобПромышл
Вал карданный ТМЗ- NUMBER - NUMBER 	Запчасти
Ускоритель Accelerator BS STEULER-KCH	Химпродукция
Отопитель AT NUMBER  Evo  NUMBER V дизель	ВычОргТехн и З/Ч
Ремень приводной С(В) NUMBER 	ИзделияРезино-технич
Планка деревянная  NUMBER х NUMBER х NUMBER  с тепл обр	Реле
Стакан ч. NUMBER - NUMBER 	Запчасти
Шайба промежуточная ч.В- NUMBER - NUMBER - NUMBER 	Запчасти
Аккумулятор к фонарю Космос  NUMBER V  NUMBER , NUMBER Ah	Запчасти
Элемент питания приборн P NUMBER  круглый	АккумБатареи и Элем
Соединение прям быстроразъем KQ NUMBER H NUMBER - NUMBER S	З/Ч Гидрооборудован
Провод обмот ПЭТ- NUMBER - NUMBER  ф NUMBER , NUMBER мм	Кабельно-проводников
Фильтр  NUMBER . NUMBER  ф NUMBER , NUMBER  VA № NUMBER - NUMBER - NUMBER . NUMBER 	Запчасти
Сульфарсазен чда	РеактивыХимич.
Рукав РВД  NUMBER - NUMBER , NUMBER  (М NUMBER х NUMBER , NUMBER )  NUMBER мм	ИзделияРезино-технич
Муфта полипроп разборная НР Ф NUMBER   NUMBER / NUMBER 	ИздИзПолимеровСтанд
Подшипник  NUMBER  EKTN NUMBER +H NUMBER 	Подшипники
Контакт неподвижный РГАП. NUMBER . NUMBER 	ЗЧ АвтоматПускКонтак
Эмаль НЦ- NUMBER  красная	Химпродукция
Шайба пружинная  NUMBER  ГОСТ NUMBER - NUMBER 	Метизы
Помпа П- NUMBER М	Запчасти
Сверло спиральное ц/х  NUMBER , NUMBER 	Сверла
Плита ИСТ  NUMBER . NUMBER . NUMBER . NUMBER  ЛЦ	ОборуТехнологическое
Уплот штока S NUMBER - NUMBER М NUMBER х NUMBER х NUMBER  Ecorubber NUMBER 	ИздИзПолимерПоЧертеж
Уголок с гайкой VBDKO  NUMBER -S	Запчасти
Фитинг FI-G- NUMBER S-W NUMBER -MS  NUMBER 	Арматура к трубам
Уплотнение EK  NUMBER x NUMBER x NUMBER , NUMBER  BI-N B NUMBER B NUMBER 	Запчасти
Винт  NUMBER 	Резцы
Ось СН NUMBER - NUMBER А	З/Ч по чертежам
Клапан DBDS NUMBER K NUMBER X/ NUMBER /V	Запчасти
Переключатель управления ПЕ  NUMBER  исп  NUMBER 	Запчасти
Гайка М NUMBER  ГОСТ  NUMBER - NUMBER  (DIN NUMBER )	Метизы
Шкив тормозной ч.М- NUMBER - NUMBER 	Запчасти
Развертка машинная к/х  NUMBER , NUMBER  Н NUMBER 	Инструмент режущий
Стол радиомонтажника СРМ- NUMBER ПФ	ОборудПрочее
Пускатель ПМЛ- NUMBER   NUMBER в с реле П+С IP NUMBER 	Запчасти
Фреза пазовая затыл  NUMBER х NUMBER 	Фрезы
РВД  NUMBER - NUMBER -AOS/AOS- NUMBER х NUMBER / NUMBER х NUMBER - NUMBER 	Запчасти
Заглушка полиэтиленовая ф NUMBER х NUMBER 	ИздДляТрубПредохран
Стол хромат ЛАБ-PRO СХ-Т NUMBER   NUMBER . NUMBER . NUMBER / NUMBER 	ОборуТехнологическое
Гайка бронз  NUMBER L NUMBER . NUMBER 	Метизы
Клапан  NUMBER  Scheuerle	З/Ч ТракСтроитТехн
Манжета армир  NUMBER х NUMBER х NUMBER  ГОСТ  NUMBER - NUMBER 	ИзделияРезино-технич
Симистор ТС NUMBER - NUMBER - NUMBER кл	КонтрИзмеритПриборы
Подшипник GE  NUMBER  ES	Запчасти
Машина для маркировки е NUMBER -р NUMBER - NUMBER 	Инструм. мерительный
Подшипник NUP NUMBER -E-XL-TVP NUMBER 	Запчасти
Клапан эл магнитный  NUMBER 	АрматураТрубопровод
Строп стал канат УСК NUMBER - NUMBER , NUMBER / NUMBER 	Стропы
Манжета армир.  NUMBER . NUMBER - NUMBER х NUMBER 	Запчасти
Метчик м/р М NUMBER х NUMBER , NUMBER  левый	Инструмент режущий
Головка торцевая  NUMBER  - NUMBER  GEDORE	Инструменты
Кобальт двухлористый ч	РеактивыХимич.
Звонок громкого боя М NUMBER - NUMBER 	Запчасти
Шайба диэлектрическая  NUMBER . NUMBER 	З/Ч по чертежам
Пластина твердосплавная LNXR  NUMBER 	Метизы
Заглушка полиэтиленовая ф NUMBER х NUMBER , NUMBER 	ИздДляТрубПредохран
Жало паяльника Goot PX- NUMBER RT- NUMBER СR	Инстр. электрический
Кран низкого давления G  NUMBER  № NUMBER - NUMBER - NUMBER . NUMBER 	Запчасти
ЭлектрощеткаМГ  NUMBER , NUMBER Х NUMBER Х NUMBER L NUMBER   NUMBER В NUMBER Х NUMBER  К NUMBER - NUMBER 	Запчасти
Кольцо R NUMBER   NUMBER , NUMBER x NUMBER , NUMBER  Ecorubber- NUMBER 	Запчасти
Кислота уксусная	Химпродукция
Муфта выключ сц  NUMBER  КАМАЗ  NUMBER 	З/Ч АвтомобПромышл
Пластина FI-GP- NUMBER L-W NUMBER A-T NUMBER N NUMBER /N NUMBER 	Инструмент слесарный
Датчик BES  NUMBER - NUMBER -M NUMBER -E Balluff	Запчасти
Подшипник  NUMBER CC/W NUMBER 	Подшипники
Фильтроэлемент RE  NUMBER G NUMBER B/ NUMBER 	Фильтры, фильтроэлем
Сода кальцинир марка Б сорт  NUMBER 	ХимПродОбщехимНазн
Трубка полиуретановая TU  NUMBER C- NUMBER   NUMBER м	Электроизоляционные
Дифавтомат АД- NUMBER   NUMBER Р  NUMBER а  NUMBER мА	Запчасти
Компл упл г/ц №  NUMBER   NUMBER   NUMBER 	Запчасти
Труба ПП ф NUMBER 	Металлопрокат
Направляющая ч.Э- NUMBER . NUMBER . NUMBER - NUMBER 	Запчасти
Полоска магнит индик сереб покр к-т  NUMBER ед	ХимПродОбщехимНазн
Подшипник  NUMBER  ГОСТ  NUMBER - NUMBER 	Подшипники
Плита бронз  NUMBER L NUMBER . NUMBER  ТПЦ- NUMBER 	З/Ч по чертежам
Пластина FI-GP- NUMBER L/S-W NUMBER A-T NUMBER N NUMBER /N NUMBER 	Инструмент слесарный
Пневмоцилиндр DNGZK- NUMBER - NUMBER -PPV-A	З/Ч Пневмооборудов
Болт М NUMBER х NUMBER  ГОСТ NUMBER - NUMBER 	Метизы
Лампа св/д  NUMBER   NUMBER  NLL-G-T NUMBER - NUMBER - NUMBER - NUMBER K-G NUMBER 	Комплектующие электр
Насос фекальный СД NUMBER / NUMBER 	Насосы
Плашка М NUMBER х NUMBER , NUMBER 	Инструмент режущий
Вкладыш к АН- NUMBER /АН NUMBER М  NUMBER М NUMBER . NUMBER . NUMBER 	Запчасти
Муфта стальная Ду NUMBER 	Запчасти
Рукав напорный ПАР NUMBER   NUMBER х NUMBER - NUMBER , NUMBER 	ИзделияРезино-технич
Кольцо ч. NUMBER . NUMBER . NUMBER 	Запчасти
Шайба МВ NUMBER  ГОСТ NUMBER - NUMBER (DIN NUMBER )	Метизы
Насос НШ  NUMBER А+ NUMBER Г- NUMBER 	Насосы
Клапан В NUMBER 	З/Ч по чертежам
Двигатель АИР  NUMBER М NUMBER У NUMBER   NUMBER / NUMBER  IM NUMBER 	Запчасти
Кран пробк муфт  NUMBER Б NUMBER бк Ду NUMBER  Ру NUMBER 	АрматураТрубопровод
Болт М NUMBER х NUMBER  ГОСТ NUMBER - NUMBER 	Метизы
Гайка бронз СН NUMBER - NUMBER СБ ТПЦ- NUMBER 	З/Ч по чертежам
Лак ABDE Art № NUMBER  защитный желтый	Запчасти
Труба ПВДФ ф NUMBER х NUMBER , NUMBER  Pу NUMBER  гладкая	ИздИзПолимеровСтанд
Кран КШХ  NUMBER . NUMBER .С NUMBER . NUMBER . NUMBER .В. NUMBER  МЭОФ	Запчасти
Подшипник  NUMBER LLU/ NUMBER K	Запчасти
Клапан эл магн газовый VAS NUMBER R/LW	З/Ч к компрессорам
Отвертка диэлектрическая плос  NUMBER х NUMBER 	Инструменты
Ниппель MG NUMBER  SKAO  NUMBER x NUMBER VA	Запчасти
Клавиатура Magic Keyboard	ОборудБытовое
Пила ленточная б/м М NUMBER   NUMBER х NUMBER х NUMBER , NUMBER х NUMBER / NUMBER 	Пилы
Шкаф вытяжной ЛК- NUMBER  ШВ  NUMBER х NUMBER х NUMBER 	Запчасти
Насос MFZPX NUMBER P NUMBER EPOA шестеренный	Насосы
Кронштейн ч.В- NUMBER - NUMBER - NUMBER СБ	Запчасти
Кабель OLFLEX CLASSIC  NUMBER   NUMBER G  NUMBER , NUMBER 	Кабельная продукция
Тройник полиэтиленовый ф NUMBER х NUMBER мм угол  NUMBER 	ИздИзПолимеровСтанд
Смесь резиновая  NUMBER - NUMBER - NUMBER 	Посуда и приборы хим
Якорь стартера  NUMBER . NUMBER  МАЗ дв ЯМЗ- NUMBER 	З/Ч АвтомобПромышл
Насос X NUMBER M NUMBER D NUMBER -J NUMBER LB NUMBER 	Насосы
Регулятор давлен воз  NUMBER . NUMBER . NUMBER - NUMBER МАЗ	З/Ч АвтомобПромышл
Удлинитель  NUMBER гн  NUMBER м  NUMBER х NUMBER , NUMBER мм NUMBER  УК NUMBER 	Изделия электроустан
Пластина тв спл S-TPEW  NUMBER XX  NUMBER 	Сплав твердый
Тележка  NUMBER - NUMBER СБ ТПЦ- NUMBER 	З/Ч по чертежам
Заглушка полиэтиленовая ф NUMBER х NUMBER 	ИздДляТрубПредохран
Пластина тв спл FX  NUMBER . NUMBER  NO. NUMBER  R NUMBER  GM NUMBER 	Сплав твердый
Кирпич SYNCARBON C S NUMBER T NUMBER   NUMBER / NUMBER 	Огнеупоры
Разъем РпИм  NUMBER , NUMBER - NUMBER , NUMBER  плоский	ДиодТранзисторТирист
Сверло коронка тв спл по метал  NUMBER мм	Сверла
Платик ч.НР NUMBER . NUMBER . NUMBER . NUMBER 	Запчасти
Масло G-Profi MSI  NUMBER W NUMBER  CI- NUMBER /SLE NUMBER  А NUMBER /В NUMBER 	Масла фасовочные
Штифт ч. NUMBER .U NUMBER / NUMBER . NUMBER  изм. NUMBER  поз. NUMBER 	Запчасти
Масло Лукойл ТМ- NUMBER ,ТМ- NUMBER 	Масла фасовочные
Шток ч. NUMBER - NUMBER 	Запчасти
Подшипник  NUMBER  ( NUMBER )	Подшипники
Болт фундам  NUMBER . NUMBER М NUMBER х NUMBER  ГОСТ NUMBER . NUMBER 	Метизы
Трубка полиамидная ф NUMBER 	Запчасти
Подшипник NU  NUMBER  ECML SKF	Запчасти
Разъем розетка-вилка РШ-ВШ  NUMBER   NUMBER а  NUMBER в	Изделия электроустан
Провод установ жарост ПАЛ  NUMBER х NUMBER , NUMBER 	Кабельно-проводников
Переключатель ПК NUMBER - NUMBER  С NUMBER  УХЛ NUMBER 	Запчасти
Строп стал канат УСК NUMBER - NUMBER , NUMBER / NUMBER 	Стропы
Группа  NUMBER  контактная замка зажиг ГАЗ  NUMBER 	З/Ч АвтомобПромышл
Фторопласт Ф- NUMBER  стержень ф NUMBER мм	ИздИзПолимеровСтанд
Аппарат для анализа кислорода АК-М NUMBER 	ОборудБытовое
Фильтр  NUMBER ФГМ NUMBER - NUMBER К	Запчасти
Гидромуфта прив вентил  NUMBER  ДВС Камаз	З/Ч АвтомобПромышл
Муфта соединительная ч.В- NUMBER - NUMBER СБ	Запчасти
Пипетка с одной отметкой  NUMBER - NUMBER - NUMBER 	Посуда и приборы хим
Кабель силовой гибкий КПГ NUMBER У  NUMBER х NUMBER + NUMBER х NUMBER 	Кабельно-проводников
Лыжа Т левая НК NUMBER . NUMBER . NUMBER . NUMBER СБ- NUMBER  ТЭСЦ	З/Ч по чертежам
Масло гидравлическое HLP NUMBER  в таре	Масла фасовочные
Масса огнеупорная Borcast- NUMBER  WTA	Спецогнеупоры
Подшипник качения  NUMBER   NUMBER 	Запчасти
Клапан DB NUMBER G NUMBER - NUMBER / NUMBER XU	Запчасти
Измеритель-регулятор ТРМ  NUMBER -Щ NUMBER .РР	Запчасти
Подшипник  NUMBER - NUMBER А NUMBER  ступичный КАМАЗ	З/Ч АвтомобПромышл
Автомат ВА NUMBER -Ф NUMBER - NUMBER - NUMBER УХЛЗ NUMBER а	Запчасти
Фотореле ФБ- NUMBER М  NUMBER кВт  NUMBER А IP NUMBER 	Запчасти
Рукав РВД  NUMBER х NUMBER DKO(Г) NUMBER х NUMBER   NUMBER   NUMBER мм	ИзделияРезино-технич
Насос SNF NUMBER  ER NUMBER  U NUMBER . NUMBER -W NUMBER 	Запчасти
Строп стал цепн  NUMBER СЦ- NUMBER , NUMBER П  NUMBER 	Стропы
Накопитель HDD SATA  NUMBER TB	ВычОргТехн и З/Ч
Оправка цилинд. ч.М NUMBER . NUMBER . NUMBER . NUMBER . NUMBER - NUMBER 	Запчасти
Вал-шестерня ч.В- NUMBER - NUMBER 	Запчасти
Электрод сварочный UTP  NUMBER  ф NUMBER , NUMBER 	Метизы
Вал-ш  NUMBER ст.ред.KS NUMBER - NUMBER S кл. NUMBER  ч. NUMBER 	Запчасти
Червяк  NUMBER L NUMBER . NUMBER  ТПЦ- NUMBER 	З/Ч по чертежам
Отвод  NUMBER - NUMBER х NUMBER , NUMBER  ст NUMBER 	Арматура к трубам
Винт М NUMBER х NUMBER   NUMBER . NUMBER  ГОСТ NUMBER ,DIN NUMBER 	Метизы
Контактор  NUMBER RT NUMBER - NUMBER AP NUMBER  Siemens	Запчасти
Инструмент универсальный ЭИ NUMBER . NUMBER .СБ	З/Ч по чертежам
Шкив  NUMBER Д NUMBER . NUMBER сб ТПЦ- NUMBER 	З/Ч по чертежам
Набивка сальниковая АП- NUMBER   NUMBER х NUMBER 	ИздДляТрубПредохран
Тиристор Т NUMBER - NUMBER - NUMBER кл	ДиодТранзисторТирист
Редуктор пуск двиг П- NUMBER УД  NUMBER - NUMBER С NUMBER А ДТ  NUMBER 	Редукторы
Рукав РВД  NUMBER - NUMBER  (М NUMBER х NUMBER , NUMBER )  NUMBER мм	ИзделияРезино-технич
Шаблон ф NUMBER   NUMBER / NUMBER ФЭ ч.Э- NUMBER - NUMBER 	ОборудТехнолог
Прокладка ф NUMBER  FPM	ИздИзПолимеровСтанд
Резец BL NUMBER -DSWNR NUMBER C NUMBER -LU	Резцы
Гайковерт ручной КАТ.№ NUMBER  PICCARDI	Инструменты
Манжета армиров  NUMBER х NUMBER х NUMBER  ГОСТ  NUMBER - NUMBER 	ИзделияРезино-технич
Винт ч. NUMBER - NUMBER 	Запчасти
Уплотнен L NUMBER   NUMBER х NUMBER х NUMBER , NUMBER   NUMBER NBR  NUMBER 	ИздИзПолимерПоЧертеж
Втулка капролон ф NUMBER хф NUMBER хL NUMBER 	ИздИзПолимеровСтанд
Заглушка полиэтиленовая ф NUMBER х NUMBER 	ИздДляТрубПредохран
Контактор LC NUMBER E NUMBER B NUMBER   NUMBER A КАТ  NUMBER B AC- NUMBER 	Контакторы
Пакет манж  NUMBER х NUMBER х NUMBER  ТПЦ- NUMBER 	ИздИзПолимерПоЧертеж
Ключ гаечный омедненный  NUMBER х NUMBER 	Инструмент слесарный
Паста очищающая для рук	Хоз.товары
ТхдОН ГОСТ NUMBER   NUMBER   NUMBER   NUMBER , NUMBER 	Трубы
Сверло спиральное ц/х  NUMBER , NUMBER 	Сверла
Скоба прямая  NUMBER , NUMBER т тип G NUMBER  ОЦ	З/Ч ГрузПодъемОборуд
Мера твердости МТБ HB  NUMBER ± NUMBER   NUMBER , NUMBER / NUMBER , NUMBER   NUMBER р	Инструм. мерительный
Сверло спиральное к/х  NUMBER , NUMBER 	Сверла
Направляющая В NUMBER  ТПЦ- NUMBER 	З/Ч по чертежам
Пластина тв спл А/ NUMBER 	Сплав твердый
Паронит ПОН-Б  NUMBER 	Издел.Асбесто-технич
Электрод сварочный угольный ф NUMBER х NUMBER  ОМ	Метизы
Головка гл сверл  NUMBER - NUMBER D NUMBER  M NUMBER 	Сверла
Сверло спиральное ц/х  NUMBER , NUMBER 	Сверла
Набор прокладок ч. NUMBER - NUMBER . NUMBER 	Запчасти
Кабель OLFLEX CLASSIC  NUMBER CY  NUMBER G  NUMBER , NUMBER 	Кабельная продукция
РВД HD NUMBER -PN NUMBER SF-PA NUMBER SF-PN NUMBER S-F NUMBER HYDAC	ИзделияРезино-технич
Резец проходной упор отогн  NUMBER х NUMBER  Т NUMBER К NUMBER 	Резцы
Ролик ч. NUMBER СБ	Запчасти
Вал В NUMBER  ТПЦ- NUMBER 	З/Ч по чертежам
Труба БШХТ ф NUMBER х NUMBER  Н NUMBER  прецизионная	Металлопрокат
Пруток металл GreenLee FTS NUMBER -DL- NUMBER 	МеталлопрокатЦветной
Цепь С NUMBER М NUMBER - NUMBER - NUMBER - NUMBER 	МетПродМашиностроен.
Дюбель-гвоздь  NUMBER х NUMBER 	Метизы
Фотодиод ФД- NUMBER К	ОборудБытовое
Прокладка  NUMBER х NUMBER  Novaphit super HPC  NUMBER , NUMBER 	Посуда и приборы хим
Втулка упругая В NUMBER  ч.Д  NUMBER - NUMBER 	Запчасти
Блок контактный Сelox В LC NUMBER 	Запчасти
Воронка В- NUMBER - NUMBER  ХС	Посуда и приборы хим
Краска для разметки дорог желтая	Стройматериалы
Трубка электроизоляционная ТЛВ ф NUMBER , NUMBER мм	Изделия электроустан
Клапан запорн прох фл  NUMBER кч NUMBER п Ду NUMBER  Ру NUMBER 	АрматураТрубопровод
Вал-шестерня ч.В- NUMBER - NUMBER - NUMBER  изм. NUMBER 	Запчасти
Автомат Электрон Э NUMBER - NUMBER А эл двиг прив	ВыключатАвтоматич
Подшипник NU  NUMBER  ECMA SKF	Подшипники
Клапан ч. NUMBER - NUMBER 	Запчасти
Композиция Экомет  NUMBER 	Стройматериалы
Шестерня ч.Р- NUMBER - NUMBER 	Запчасти
Отражатель опт датч  NUMBER x NUMBER PL NUMBER A Sick	ДатчСистемАвтоматики
Соединение муфтовое PPR ВР  NUMBER х NUMBER 	ИздИзПолимеровСтанд
Трубка электроизоляционная ТЛВ ф NUMBER , NUMBER мм	Изделия электроустан
Эмаль НЦ- NUMBER  зеленая ГОСТ  NUMBER - NUMBER 	Прод.Лако-красочная
Блок канатный ARG NUMBER - NUMBER - NUMBER , NUMBER - NUMBER 	З/Ч ГрузПодъемОборуд
Игла маркирования sic  NUMBER 	Запчасти
Фланец Ду NUMBER  РУ NUMBER 	АрматураТрубопровод
Резец резьбовой наружный  NUMBER Х NUMBER  ВК NUMBER 	Резцы
Люксметр-Яркомер Пульсметр еЛайт NUMBER 	КонтрИзмеритПриборы
Металлорукав РЗЦ ф NUMBER 	Кабельная продукция
Болт  NUMBER х NUMBER  А NUMBER  DIN NUMBER 	Метизы
Клапан Z NUMBER  DV NUMBER  № NUMBER . NUMBER . NUMBER  ВЕКА	Запчасти
Болт нержав М NUMBER х NUMBER  А NUMBER  DIN NUMBER 	Метизы
Датчик IFM  NUMBER D NUMBER - NUMBER DLF NUMBER KG	ДатчСистемАвтоматики
Компрессор СК- NUMBER  к холод агрегатам	Запчасти
Бурт ПВДФ ф NUMBER 	ИздИзПолимеровСтанд
Стартер СТ  NUMBER   NUMBER - NUMBER  ЯМЗ- NUMBER  МАЗ	З/Ч АвтомобПромышл
Плашка М NUMBER х NUMBER , NUMBER 	Инструмент режущий
Рашпиль драчевый полукруглый	Инструмент слесарный
Панель управл  NUMBER SE NUMBER - NUMBER BP NUMBER - NUMBER AA NUMBER 	ПриборыСистАвтоматик
Контактор  NUMBER RV NUMBER - NUMBER BA NUMBER  Siemens	Запчасти
Насос Wilo BAC  NUMBER - NUMBER - NUMBER . NUMBER / NUMBER -DM/R- NUMBER 	Насосы
Контактор LC NUMBER E NUMBER F NUMBER   NUMBER A КАТ  NUMBER B AC- NUMBER 	Контакторы
Хомут червячный  NUMBER - NUMBER 	Запчасти
Подшипник МПЗ  NUMBER  ( NUMBER )	Подшипники
Отвод  NUMBER - NUMBER - NUMBER , NUMBER х NUMBER , NUMBER  ст NUMBER Х NUMBER Н NUMBER Т	Арматура к трубам
Шестерня коробки скоростей ч. NUMBER - NUMBER - NUMBER 	Запчасти
Болт М NUMBER х NUMBER  оц DIN NUMBER 	Метизы
Клапан игольч  NUMBER с NUMBER бк Ду NUMBER  Ру NUMBER  (ВИ NUMBER )	АрматураТрубопровод
Звено  NUMBER RT NUMBER - NUMBER CD NUMBER  Siemens	Запчасти
Уголок полипропиленовый  NUMBER  град ф NUMBER 	ИздИзПолимеровСтанд
Тележка ведущая Gr. NUMBER ,GK:SP,RF R NUMBER - NUMBER 	Запчасти
Болт М NUMBER х NUMBER  ГОСТ NUMBER - NUMBER 	Метизы
Лента измерит рулетка Р- NUMBER м УЗК	Инструм. мерительный
Крючок М NUMBER  L= NUMBER  ч. NUMBER А- NUMBER 	Запчасти
Винт  NUMBER х NUMBER   NUMBER . NUMBER .ГОСТ NUMBER - NUMBER (DIN NUMBER )	Метизы
Эмаль НЦ- NUMBER  коричневая	Прод.Лако-красочная
Панель PC  NUMBER AV NUMBER - NUMBER BF NUMBER - NUMBER AC NUMBER 	Запчасти
Фильтр  NUMBER . NUMBER . NUMBER . NUMBER . NUMBER  DN  NUMBER  № NUMBER / NUMBER 	Запчасти
Комбинация прибор  NUMBER . NUMBER  нов об ГАЗЕЛЬ	З/Ч АвтомобПромышл
Зажим клеммный  NUMBER мм NUMBER  JXB ИЭК	Изделия электроустан
Приставка контактная ПКИ- NUMBER   NUMBER з+ NUMBER р	ЗЧ АвтоматПускКонтак
Шаблон профильный ПР-НЕПР GW- NUMBER 	ОборудПрочее
Втулка бронз В NUMBER  ТПЦ- NUMBER 	З/Ч по чертежам
Сопло  NUMBER - NUMBER сб ТПЦ- NUMBER 	ИнстОснастТехнПоЧерт
Модуль ввода  NUMBER ES NUMBER - NUMBER GB NUMBER - NUMBER AB NUMBER 	Запчасти
Обвод PP ф NUMBER 	ИздИзПолимеровСтанд
Клемма WAGO  NUMBER - NUMBER 	Изделия электроустан
Колонка рулевая  NUMBER - NUMBER  трактор МТЗ	З/Ч ТракСтроитТехн
Манжета  NUMBER х NUMBER  короб отбора мощн ЯМЗ- NUMBER 	З/Ч ТракСтроитТехн
Клапан DREE  NUMBER - NUMBER X/ NUMBER YMG NUMBER K NUMBER A NUMBER M	З/Ч Гидрооборудован
Ложемент полимерно-метал  NUMBER  труб ф NUMBER , NUMBER 	ИздДляТрубПредохран
Рейка В NUMBER  ТПЦ- NUMBER 	З/Ч по чертежам
Знак эвакуационный Е  NUMBER 	ХозИнвентарь
Уплотнение  NUMBER х NUMBER х NUMBER  B NUMBER  NBR	ИздИзПолимерПоЧертеж
Поковка колесо ст NUMBER Г ф NUMBER /ф NUMBER х NUMBER  ст NUMBER Г	ПрокатЛистовойЛисты
Подшипник  NUMBER У- NUMBER А	Запчасти
Лист стальной  NUMBER х NUMBER  ст. NUMBER 	ПрокатЛистовойЛисты
Набор отверток плоских  NUMBER  SE NUMBER  USAG	Инструмент слесарный
Удлинитель  NUMBER х NUMBER м с зазем  NUMBER А	Изделия электроустан
Датчик MTS Sensor RHM NUMBER MR NUMBER AA NUMBER 	Запчасти
Вал ч.В- NUMBER - NUMBER - NUMBER 	Запчасти
Кабель силовой ВВГ- NUMBER   NUMBER х NUMBER 	Кабельно-проводников
Принтер матричный Epson TM U NUMBER P	ВычОргТехн и З/Ч
Развертка тв спл  NUMBER , NUMBER  Т NUMBER К NUMBER 	Инструмент режущий
Прокладка термостата ЗМЗ  NUMBER 	З/Ч АвтомобПромышл
Ролик СН NUMBER - NUMBER  К СБ ТПЦ- NUMBER 	З/Ч по чертежам
Болт М NUMBER х NUMBER  ГОСТ NUMBER - NUMBER 	Метизы
РВД  NUMBER - NUMBER -AJ/AJ- NUMBER x NUMBER , NUMBER / NUMBER x NUMBER , NUMBER - NUMBER 	Запчасти
Подшипник  NUMBER  ГОСТ  NUMBER - NUMBER 	Подшипники
Преобразователь напряжения ПНС- NUMBER   NUMBER В	КонтрИзмеритПриборы
Прокладка ч.НР NUMBER . NUMBER . NUMBER . NUMBER 	Запчасти
Разъем TOCP NUMBER K  NUMBER - NUMBER - NUMBER  Elfa	КонтрИзмеритПриборы
Манжета армир  NUMBER х NUMBER х NUMBER  ГОСТ  NUMBER - NUMBER 	ИзделияРезино-технич
Лист  NUMBER х NUMBER Н NUMBER Т  NUMBER х NUMBER х NUMBER 	ПрокатЛистовойЛисты
Датчик ВБО-М NUMBER - NUMBER К- NUMBER -Н	Запчасти
Комплект манжет клап  NUMBER - NUMBER  МАЗ  NUMBER ед	З/Ч АвтомобПромышл
Стекло ТРИПЛЕКС	Запчасти
Ключ рожковый  NUMBER х NUMBER   NUMBER  Gedore	Инструмент слесарный
Уплотнение торцевое ЛФПК  NUMBER . NUMBER / NUMBER /ККРС	Запчасти
Уплотнение торцевое ч. NUMBER 	Запчасти
Реле потока РПН- NUMBER 	Запчасти
"Клеймо тв спл  NUMBER "" NUMBER "" ВК NUMBER "	Инструменты
Тест набор для определения фосфат-ионов	Материалы лаб.
Пруток бронзовый ф NUMBER мм БРО NUMBER Ф NUMBER 	Металлопрокат
Тиски станочные  NUMBER 	Инструмент слесарный
Звено С- NUMBER ПР- NUMBER , NUMBER - NUMBER , NUMBER 	Цепи и звенья
Рычаг  NUMBER - NUMBER СБ ТПЦ- NUMBER 	З/Ч по чертежам
Резец отрезной  NUMBER х NUMBER  Т NUMBER К NUMBER 	Резцы
Контактор LC NUMBER E NUMBER F NUMBER   NUMBER A КАТ  NUMBER B AC- NUMBER 	Контакторы
Муфта  NUMBER / NUMBER A- NUMBER  H NUMBER  GG SOFTEX	Запчасти
Фотореле ФР  NUMBER  серый  NUMBER Вт IP NUMBER 	Реле
Подшипник  NUMBER  C NUMBER 	Подшипники
Маска сварщика Хамелеон	СИЗ (без размеров)
Прокладка ф NUMBER  Ду NUMBER  EPDM	ИздИзПолимеровСтанд
Заглушка полиэтиленовая ф NUMBER , NUMBER х NUMBER , NUMBER 	ИздДляТрубПредохран
Лист  NUMBER  ст NUMBER Х NUMBER Н NUMBER Т	ПрокатЛистовойЛисты
Лист  NUMBER  ст NUMBER 	ПрокатЛистовойЛисты
Вал  NUMBER - NUMBER - NUMBER . NUMBER . NUMBER  к насосу ЦНСГ- NUMBER - NUMBER 	Запчасти
Моновалок В- NUMBER - NUMBER 	Инструменты
Сверло спиральное к/х  NUMBER , NUMBER 	Сверла
Фреза отрезная  NUMBER х NUMBER , NUMBER 	Фрезы
Подшипник  NUMBER E SKF	Подшипники
Мотор-редуктор  NUMBER МП- NUMBER , NUMBER - NUMBER -ЦУ NUMBER - NUMBER В	Редукторы
Муфта переходная PPR  NUMBER х NUMBER 	ИздИзПолимеровСтанд
Кирпич RI-MC NUMBER LC MK  NUMBER / NUMBER 	Огнеупоры
Ремкомплект  NUMBER F NUMBER  Graco  NUMBER ед	З/Ч к компрессорам
Затвор V-KE NUMBER - D NUMBER V NUMBER N NUMBER  п/п NAMUR  NUMBER VDC	Запчасти
Подшипник  NUMBER 	Подшипники
Знак аварийной останов	ХозИнвентарь
ЩеткодержательМ NUMBER А  NUMBER , NUMBER Х NUMBER Х NUMBER  К- NUMBER  Вел  NUMBER , NUMBER 	Запчасти
Автомат ВА NUMBER - NUMBER   NUMBER Р  NUMBER а	Запчасти
Клапан сферический код NUMBER  тип ALFA NUMBER DN NUMBER 	КонтрИзмеритПриборы
Строп стал канат  NUMBER СК- NUMBER , NUMBER / NUMBER 	Стропы
Краска акриловая кузнечная WS-Plast M NUMBER 	Стройматериалы
Замок быстросъемный Камлок D  NUMBER - NUMBER / NUMBER 	ТехнологОборудЧертеж
Автомат ВА NUMBER - NUMBER   NUMBER Р  NUMBER А	Запчасти
Опора полипропиленовая ф  NUMBER мм	ИздИзПолимеровСтанд
Пила ленточная б/м М NUMBER   NUMBER х NUMBER х NUMBER , NUMBER х NUMBER / NUMBER 	Пилы
Пробка ч.НР NUMBER . NUMBER . NUMBER . NUMBER 	Запчасти
Электрочайник автомат	Резцы
Титр станд магний сернокисл  NUMBER амп	РеактивыХимич.
Смеситель для душа со стацион.трубой	Хоз.товары
Выключатель  NUMBER VL NUMBER - NUMBER DC NUMBER - NUMBER AA NUMBER  Siemens	Запчасти
Блок батарей  NUMBER v HYDAC	Запчасти
Соединитель Siemens  NUMBER ES NUMBER - NUMBER AM NUMBER - NUMBER AA NUMBER 	Запчасти
Винт высок с цил гол и шест  NUMBER х NUMBER  кл NUMBER . NUMBER 	Метизы
Подшипник  NUMBER (ZARN NUMBER TN)	Подшипники
Пипетка с одной отметкой  NUMBER - NUMBER - NUMBER 	Посуда и приборы хим
Сверло с ц/х  NUMBER , NUMBER 	Сверла
Ремкомплект клапана SK- NUMBER  Bronx  NUMBER ед	З/Ч Гидрооборудован
Пластина тв спл DNMG  NUMBER EM  NUMBER 	Сплав твердый
Стартер СТ  NUMBER -Б NUMBER  ЗМЗ- NUMBER 	З/Ч АвтомобПромышл
Заготовка оправка ф NUMBER м ст NUMBER ХН NUMBER Ф	Металлопрокат
Кувалда  NUMBER кг	Инструмент слесарный
Канат стальной  NUMBER - NUMBER  ГОСТ  NUMBER - NUMBER 	Метизы
Масло Лукойл Стило  NUMBER 	Масла фасовочные
Кожух фланц КЗП Ду NUMBER   NUMBER х NUMBER х NUMBER  ПВД	ИздИзПолимеровСтанд
Наконечник изолированный НкИш  NUMBER , NUMBER - NUMBER , NUMBER мм NUMBER 	Изделия электроустан
Коробка коммуникационная КРК- NUMBER 	Электроизоляционные
Труба USE NUMBER  с резьбой U&S	З/Ч по чертежам
Колесо червячное  NUMBER L NUMBER . NUMBER  ТПЦ- NUMBER 	З/Ч по чертежам
Рукав пожарн ф NUMBER мм с  NUMBER -стор полимер покр	Инструм. абразивный
Ручка шариковая	Канцтовары
Фитинг FI-GE- NUMBER SR NUMBER -WD-B-W NUMBER -MS  NUMBER 	Арматура к трубам
Патрубок КОМ на резъбе  NUMBER - NUMBER КАМАЗ	З/Ч АвтомобПромышл
Уплотнение S NUMBER -P  NUMBER x NUMBER x NUMBER , NUMBER  NBR/PU	Запчасти
Шестерня ч. NUMBER А NUMBER - NUMBER . NUMBER . NUMBER / NUMBER 	Запчасти
Ключ гаечный кольцевой коленч КГН  NUMBER х NUMBER 	Инструмент слесарный
Г/цCYH NUMBER MT NUMBER / NUMBER / NUMBER /.. NUMBER A NUMBER /X NUMBER CMUTXXD NUMBER 	Запчасти
Ремень приводной А NUMBER 	Запчасти
Зажим входной WAGO  NUMBER - NUMBER 	З/Ч ГрузПодъемОборуд
Оправка FI-MVK- NUMBER S-PRC-W NUMBER 	Инструмент слесарный
Подшипник  NUMBER / NUMBER  CA/W NUMBER 	Подшипники
Оголовок  NUMBER . NUMBER . NUMBER СБ ЭСПЦ	ОборуТехнологическое
Полумуфта ч.Э- NUMBER . NUMBER . NUMBER . NUMBER А	Запчасти
Кольцо R NUMBER   NUMBER х NUMBER  Viton NUMBER 	Запчасти
Пипетка Мора  NUMBER 	Посуда и приборы хим
Светильник LED  NUMBER Вт  NUMBER Х NUMBER х NUMBER  встр/накл	СветотехнИсточнСвета
Кабель OLFLEX-SERVO-FD  NUMBER  CP  NUMBER  G  NUMBER , NUMBER 	Кабельная продукция
Дисплей th-tune CAREL  NUMBER  VAC ATC NUMBER ADO	МодулПлатыСистАвтом
Кольцо В NUMBER  ТПЦ- NUMBER 	З/Ч по чертежам
Клапан Z NUMBER FS  NUMBER -A NUMBER - NUMBER X/ NUMBER QV арт R NUMBER 	Запчасти
Розетка  NUMBER TE NUMBER  мод на DIN-рейку SIEMENS	Изделия электроустан
Пирометр IMPAC IP NUMBER   NUMBER 	КонтрИзмеритПриборы
Плашка метрической резьбы М NUMBER   NUMBER - NUMBER 	Инструменты
Вал БТС NUMBER . NUMBER . NUMBER  ТПЦ- NUMBER 	З/Ч по чертежам
Сегмент  NUMBER . NUMBER . NUMBER СБ ТЭСЦ	З/Ч по чертежам
Кабель OLFLEX CRANE NSHTOU  NUMBER G NUMBER 	Кабельно-проводников
Гидромотор  NUMBER - NUMBER - NUMBER 	З/Ч Гидрооборудован
Платик ч.НР NUMBER . NUMBER . NUMBER . NUMBER 	Запчасти
Реле РЭП- NUMBER  кат  NUMBER в	Реле
Фланец  NUMBER - NUMBER - NUMBER 	АрматураТрубопровод
Датчик Sick DGS NUMBER -HAZ NUMBER -S NUMBER 	ДатчСистемАвтоматики
Вентилятор Scythe S-Flex SFF NUMBER D d NUMBER мм	Запчасти
Подшипник  NUMBER  (NU NUMBER )	Подшипники
Болт М NUMBER х NUMBER  ГОСТ NUMBER - NUMBER 	Метизы
Ключ гаечный накидной  NUMBER х NUMBER 	Инструменты
Головка расточная ИР- NUMBER 	Инструменты
Манжета ч. NUMBER - NUMBER -А	Запчасти
Подшипник  NUMBER - NUMBER Z	Запчасти
Точило электрическое Диолд ЭТ- NUMBER , NUMBER КВт	ХимПродОбщехимНазн
Датчик NUMBER -ДИ- NUMBER - NUMBER , NUMBER / NUMBER МПа- NUMBER -Т NUMBER -С-Н-ГП	Запчасти
Сухарь нажимной NLM  NUMBER - NUMBER  NORELEM	Запчасти
Уплотнение K NUMBER -P  NUMBER , NUMBER x NUMBER x NUMBER , NUMBER  Ecopur/NBR	ИздИзПолимерПоЧертеж
Растворитель  NUMBER - NUMBER - NUMBER 	Прод.Лако-красочная
Подшипник NUP  NUMBER  ECP	Подшипники
Плашка М NUMBER х NUMBER , NUMBER 	Инструмент режущий
Электрод сварочный ЦЛ- NUMBER  ф NUMBER 	Метизы
Рукав РВД  NUMBER - NUMBER  (м NUMBER х NUMBER , NUMBER )  NUMBER мм	ИзделияРезино-технич
Панель задн част крыла  NUMBER  правКАМАЗ	З/Ч АвтомобПромышл
Автомат АП NUMBER Б- NUMBER МТ  NUMBER а	ВыключатАвтоматич
Стартер  NUMBER  Sennebogen	З/Ч ТракСтроитТехн
Блок управления сервоклап DSG- NUMBER - NUMBER 	Запчасти
Трубка огнеупорная МКРЦ	Мебель
Сверло спиральное ц/х  NUMBER , NUMBER 	Сверла
Строп стал канат УСК NUMBER - NUMBER , NUMBER / NUMBER 	Стропы
ГСО  NUMBER - NUMBER П	Химпродукция
Болт М NUMBER х NUMBER  ГОСТ NUMBER - NUMBER 	Метизы
Подшипник  NUMBER  ( NUMBER  Z)	Подшипники
Сверло спиральное ц/х  NUMBER , NUMBER 	Сверла
Фланец  NUMBER - NUMBER  ТПЦ- NUMBER 	З/Ч по чертежам
Реле электротепловое РТИ- NUMBER   NUMBER А	Запчасти
Кисть малярная плоская В  NUMBER 	Инструменты
Реле REL-MR- NUMBER DC/ NUMBER - NUMBER  кат  NUMBER VDC  NUMBER 	Реле
Редуктор CS NUMBER  нижний Badoni	Запчасти
Дроссель  NUMBER И  NUMBER / NUMBER  АВТ	Запчасти
Тигель кварцевый В NUMBER 	Запчасти
Подшипник  NUMBER  ( NUMBER )	Подшипники
Болт М NUMBER х NUMBER   NUMBER . NUMBER  ГОСТ Р NUMBER - NUMBER 	Метизы
Кулачок ч.Э- NUMBER - NUMBER 	Запчасти
Швеллер стальной  NUMBER 	Металлопрокат
Датчик давл  NUMBER . NUMBER  БЕЛАЗ	З/Ч ТракСтроитТехн
Подшипник  NUMBER - NUMBER 	Запчасти
Материал огнеупорный Licofest PL  NUMBER QH	Арматура к трубам
Полотно нетканое	Канцтовары
Вал полый шлицевой КР NUMBER 	Инструм. абразивный
Стол-парта одноместная	Мебель
Преоб П NUMBER - NUMBER , NUMBER - NUMBER -Север- NUMBER Т NUMBER -БшПр- NUMBER 	ДатчСистемАвтоматики
Трубка индик ацетон  NUMBER - NUMBER ( NUMBER , NUMBER )	РеактивыХимич.
Комплект образцов SRM NUMBER   NUMBER х NUMBER х NUMBER мм	Запчасти
Напильник круглый  NUMBER  № NUMBER 	Инструменты
Головка резьбовая ВОR NUMBER Е-Т-СSСPL NUMBER - NUMBER 	Резцы
Кольцо ч. NUMBER . NUMBER . NUMBER . NUMBER А/ NUMBER 	Запчасти
Болт М NUMBER х NUMBER  Б NUMBER . NUMBER . NUMBER . NUMBER 	Метизы
Процессор центральный  NUMBER ES NUMBER - NUMBER AG NUMBER - NUMBER AB NUMBER 	ПриборыСистАвтоматик
'Фильтр регулятор AW NUMBER -F NUMBER C  NUMBER мм  NUMBER / NUMBER ''	З/Ч Пневмооборудов
Картридж HP LJ  NUMBER  Q NUMBER A Magenta	Расходные материалы
Датчик лазерный IFM O NUMBER D NUMBER  O NUMBER DLCPKG/US	ДатчСистемАвтоматики
Брус  NUMBER х NUMBER х NUMBER  с тепловой обработкой	ИздДляТрубПредохран
Электрод  NUMBER  Encore NORDSON	ОборуТехнологическое
Комбинезон микрогард  NUMBER  плюс	З/Ч ТракСтроитТехн
Заглушка полиэтиленовая ф NUMBER х NUMBER 	ИздДляТрубПредохран
Клапан  NUMBER WEH NUMBER J NUMBER X/ NUMBER EW NUMBER N NUMBER K NUMBER 	З/Ч Гидрооборудован
Муфта ПВД с переходом на мет NUMBER * NUMBER / NUMBER  внут	Хоз.товары
Метчик м/р М NUMBER х NUMBER , NUMBER  компл  NUMBER ед	Инструмент режущий
Палец кассеты ч. NUMBER - NUMBER . NUMBER 	Запчасти
Кран шаров фл нерж Ду NUMBER  Ру NUMBER  пневмоприв	АрматураТрубопровод
Трубка электроизоляционная ТКР ф NUMBER , NUMBER мм	Изделия электроустан
Клапан  NUMBER / NUMBER -ходовой V NUMBER A NUMBER D-C NUMBER A	Запчасти
Манометр МП NUMBER -УУ NUMBER   NUMBER - NUMBER кгс/см NUMBER 	КонтрИзмеритПриборы
Болт М NUMBER х NUMBER  ГОСТ NUMBER - NUMBER 	Метизы
Термосмазка Canon HP CK- NUMBER  FY NUMBER - NUMBER 	ОборуТехнологическое
Сверло  NUMBER , NUMBER  ГОСТ NUMBER - NUMBER 	Инструменты
Соединение быстроразъем Камлок SSF- NUMBER 	Запчасти
Ремень зубчатый СБ  NUMBER - NUMBER - NUMBER 	ИзделияРезино-технич
Плита  NUMBER . NUMBER . NUMBER . NUMBER . NUMBER  ТПЦ- NUMBER 	ИнстОснастТехнПоЧерт
Рама распорная  NUMBER х NUMBER х NUMBER  ч.Э- NUMBER 	Стройматериалы
Вал  NUMBER . NUMBER . NUMBER  ТЭСЦ	З/Ч по чертежам
Соль поваренная	РеактивыХимич.
Болт М NUMBER х NUMBER  ГОСТ NUMBER - NUMBER 	Метизы
Выключатель дифф. ВД NUMBER - NUMBER   NUMBER р  NUMBER А/ NUMBER мА	Запчасти
Устройство USE NUMBER L U&S	З/Ч по чертежам
Задвижка фланц  NUMBER с NUMBER нж Ду NUMBER  Ру NUMBER  с КОФ	АрматураТрубопровод
Саморез д/монтажа сэндвичпанелей  NUMBER х NUMBER 	Метизы
Катридж для дионизации воды к.н. А NUMBER 	КонтрИзмеритПриборы
Труба гофрированная ф NUMBER - NUMBER  ДКС	Стройматериалы
Устройство регулир сопла USB NUMBER  U&S	Запчасти
Наушник-вкладыш одноразовый арт. NUMBER 	ХозИнвентарь
Модуль Phoenix Contact SACB- NUMBER / NUMBER -C	Запчасти
Звено С-ПР- NUMBER , NUMBER - NUMBER 	Цепи и звенья
Лампа  NUMBER v- NUMBER w поворотника	Комплектующие электр
Растворитель  NUMBER 	Прод.Лако-красочная
Резец сборный PSSNR  NUMBER  M NUMBER 	Резцы
Сопло SDS  NUMBER F	ИнстОснастТехнПоЧерт
Гидромотор МГП- NUMBER  ф NUMBER 	З/Ч Гидрооборудован
Уплотнение ч. NUMBER 	Запчасти
Электрод сварочн ESAB OK  NUMBER - NUMBER  VP ф NUMBER , NUMBER 	Метизы
Секция ванны наружная  NUMBER - NUMBER СБ ТПЦ- NUMBER 	З/Ч по чертежам
Рама Д NUMBER - NUMBER 	ОборуТехнологическое
Гидроцилиндр SMS № NUMBER 	Запчасти
Сверло спиральное к/х  NUMBER , NUMBER 	Сверла
Кирпич ANCARBON CN NUMBER   NUMBER / NUMBER 	Огнеупоры
Таль ручн передв червяч г/п  NUMBER тн Н- NUMBER м	КраныТельферыЛебедки
Ролик несущий ф NUMBER хEL= NUMBER  GUP № NUMBER # NUMBER 	З/Ч по чертежам
Лист  NUMBER  ст NUMBER сп/пс	Металлопрокат
Заглушка полиэтиленовая ф NUMBER х NUMBER 	ИздДляТрубПредохран
Трубка турбины подв NUMBER  Cummins КАМАЗ	З/Ч АвтомобПромышл
Болт М NUMBER х NUMBER  ГОСТ NUMBER - NUMBER 	Метизы
Щит пожарный укомплектованный ЩП-В	Запчасти
Подкладка ч.Э- NUMBER - NUMBER - NUMBER 	Запчасти
Подшипник полуоси  NUMBER  Волга	Подшипники
Кран блочный шаровый BKR  NUMBER  ND	Запчасти
Фильтр воздушный Toyota Camry V NUMBER 	З/Ч АвтомобПромышл
'Калибр пробка резьбов Buttress  NUMBER   NUMBER / NUMBER ''	Инструм. мерительный
Комплект колодок тор пер Maksima Q NUMBER   NUMBER ед	З/Ч АвтомобПромышл
Втулка вал-шестерни БрА NUMBER Ж NUMBER Л ч.П- NUMBER 	Запчасти
Пневмоцилиндр ПЦ NUMBER - NUMBER х NUMBER 	Химпродукция
Подшипник  NUMBER - NUMBER АКУ NUMBER Ш NUMBER 	Запчасти
Строп стал канат УСК NUMBER - NUMBER , NUMBER / NUMBER 	Стропы
Заглушка полиэтиленовая ф NUMBER х NUMBER 	ИздДляТрубПредохран
Электрод сварочный АНО- NUMBER  ф NUMBER 	Метизы
Фонарь задний со жгутом  NUMBER . NUMBER . NUMBER  КАМАЗ	З/Ч АвтомобПромышл
Манжета гидромуфты  NUMBER х NUMBER х NUMBER  КАМАЗ	З/Ч АвтомобПромышл
Форсунка  NUMBER . NUMBER .T NUMBER .CE	ИнстОснастТехнПоЧерт
Гратосъемник замковый  NUMBER  ДЗС	Инструменты
Контактор ABB AF NUMBER - NUMBER - NUMBER - NUMBER   NUMBER А к NUMBER в	Запчасти
Клапан МКПВ- NUMBER / NUMBER Ф NUMBER К NUMBER Г NUMBER 	Запчасти
Точка доступа Mikrotik cAP ac  NUMBER . NUMBER / NUMBER  GHz	Запчасти
Гарнитур кухонный (встроенный)	Химпродукция
Винт ч.Д NUMBER - NUMBER - NUMBER / NUMBER 	Запчасти
Строп текст петл СТП  NUMBER , NUMBER / NUMBER 	Стропы
Амперметр щитовой F NUMBER EAX NUMBER X NUMBER   NUMBER / NUMBER A	КонтрИзмеритПриборы
Трубка ПВХ ф NUMBER 	Изделия электроустан
Бочка ролика ч.Р- NUMBER - NUMBER 	Запчасти
Пластина тв спл DNMG  NUMBER  PR  NUMBER 	Сплав твердый
Круг  NUMBER  ст NUMBER Х NUMBER Н NUMBER Т	ПрокатСортовойОбНазн
Скоба прямая  NUMBER , NUMBER т тип G NUMBER  ОЦ	З/Ч ГрузПодъемОборуд
Подшипник GE NUMBER -FO- NUMBER RS	Подшипники
Цилиндр подъема стрелы лев  NUMBER - NUMBER 	З/Ч ТракСтроитТехн
Винт  NUMBER х NUMBER  ГОСТ NUMBER - NUMBER (DIN  NUMBER )	Метизы
Провод установ ПВ- NUMBER   NUMBER х NUMBER , NUMBER 	Кабельно-проводников
Помпа П- NUMBER   NUMBER 	Запчасти
Вольтметр Е NUMBER   NUMBER - NUMBER В АС	КонтрИзмеритПриборы
Кирпич периклазоуглерод ПШУ- NUMBER   NUMBER / NUMBER 	Периклазоуглеродисты
Ключ гаечный КГД  NUMBER х NUMBER 	Инструмент слесарный
Сканер штрих-кода Metrologic MK NUMBER 	Инструменты
Плита ВА- NUMBER / NUMBER /МН/ NUMBER -АL Atos	ОборуТехнологическое
Заглушка полиэтиленовая ф NUMBER х NUMBER 	ИздДляТрубПредохран
Рукав всасывающий Ду NUMBER мм с ГР- NUMBER   NUMBER метра	ИзделияРезино-технич
Металлорукав RS NUMBER  L NUMBER   NUMBER  DN NUMBER PN NUMBER LN NUMBER , NUMBER 	Запчасти
Кольцо уплотн вала  NUMBER  Х NUMBER  Х  NUMBER  A NUMBER VSO NUMBER 	Запчасти
Переход К- NUMBER - NUMBER , NUMBER х NUMBER , NUMBER - NUMBER , NUMBER х NUMBER , NUMBER  ст NUMBER 	Арматура к трубам
Масса ремонтная PN-ZBXB-A	Огнеупоры
Подшипник  NUMBER Н ГОСТ  NUMBER - NUMBER 	Запчасти
Контактор КМИ- NUMBER   NUMBER А  NUMBER В	Запчасти
Наконечник НШвИ  NUMBER , NUMBER - NUMBER 	Кабельная продукция
Рукав  NUMBER SH GH  NUMBER - NUMBER  DN NUMBER   NUMBER   NUMBER / NUMBER 	Запчасти
Подшипник  NUMBER  ГОСТ  NUMBER - NUMBER 	Подшипники
Мера установочная FSTD-LCSG- NUMBER B- NUMBER -B	Инструменты
Сталь оцинкованная рулон  NUMBER , NUMBER - NUMBER , NUMBER х NUMBER 	Металлопрокат
Кабель OLFLEX CRANE NSHTOU  NUMBER G NUMBER 	Кабельно-проводников
Розетка  NUMBER . NUMBER  для реле FINDER	Комплектующие электр
Труба полипропиленовая PN NUMBER  ф NUMBER 	ИздИзПолимеровСтанд
Тройник ф NUMBER х NUMBER / NUMBER х NUMBER  исполнение  NUMBER 	Изделия электроустан
Оправка FI-MVK- NUMBER S-PRC-W NUMBER 	Инструмент слесарный
Фильтр масляный СР № NUMBER  к ММ  NUMBER  SS	Запчасти
Эл двиг ДМТКН- NUMBER - NUMBER  У NUMBER   NUMBER , NUMBER кВт  NUMBER  об/мин	Электродвигатели
Метчик м/р М NUMBER х NUMBER , NUMBER  компл  NUMBER ед	Инструмент режущий
Толкатель клап  NUMBER   NUMBER  ДВС  NUMBER  Камаз	З/Ч АвтомобПромышл
Вал привода арт. NUMBER . NUMBER . NUMBER 	Запчасти
Рельс R  NUMBER   NUMBER   NUMBER ,  NUMBER mm	Комплектующие электр
Комплект сальников клапанов двиг УАЗ  NUMBER ед	З/Ч АвтомобПромышл
Шкурка шлифовальная  NUMBER А  NUMBER Н	Химпродукция
Винт М NUMBER х NUMBER   NUMBER . NUMBER  ГОСТ  NUMBER - NUMBER  DIN  NUMBER 	Метизы
Кольцо R NUMBER   NUMBER , NUMBER х NUMBER , NUMBER  NBR	Запчасти
Блок пит.  NUMBER EP NUMBER - NUMBER BA NUMBER  Siemens	Запчасти
Разъем  NUMBER - NUMBER - NUMBER MURR ELEKTRONIC	ДиодТранзисторТирист
Модуль DeviceNet CJ NUMBER W-DRM NUMBER  OMRON	З/Ч Гидрооборудован
Уплотнение UHGR- NUMBER   NUMBER x NUMBER x NUMBER , NUMBER  PU NUMBER 	Запчасти
Комплект сигналов ВАЗ- NUMBER   NUMBER ед	З/Ч АвтомобПромышл
Автомат S NUMBER S  NUMBER P  NUMBER А  NUMBER CСS NUMBER R NUMBER 	ВыключатАвтоматич
РВД  NUMBER - NUMBER -AOS/AOS NUMBER -M NUMBER x NUMBER /M NUMBER x NUMBER - NUMBER 	Запчасти
Провод монтажн МГШВ-С  NUMBER х NUMBER , NUMBER 	Кабельно-проводников
Насос НкпМ NUMBER - NUMBER / NUMBER  с эл двиг  NUMBER кВт	Насосы
Винт  NUMBER х NUMBER  ГОСТ NUMBER - NUMBER (DIN  NUMBER )	Метизы
Бумага ленточная диаграммная  NUMBER 	Канцтовары
Набивка ЛП- NUMBER   NUMBER мм	ИздДляТрубПредохран
Термопреобразователь ТС  NUMBER /BV NUMBER / NUMBER /Pt NUMBER 	КонтрИзмеритПриборы
Линейка измерит метал  NUMBER мм	Инструм. мерительный
Зубило  NUMBER мм	Инструмент слесарный
Шпиндель №  NUMBER - NUMBER . NUMBER 	З/Ч по чертежам
Фитинг С NUMBER 	З/Ч Пневмооборудов
Сальник  NUMBER х NUMBER х NUMBER  AS NBR	З/Ч ТракСтроитТехн
Фильтр очистки ЭФОТ  NUMBER . NUMBER . NUMBER  ЯМЗ	З/Ч АвтомобПромышл
Плунжер ч. NUMBER  (нового исполнения)	Запчасти
Винт  NUMBER х NUMBER  ГОСТ NUMBER - NUMBER (DIN  NUMBER )	Метизы
Круг отрезной  NUMBER х NUMBER х NUMBER   NUMBER С F NUMBER  R,S BF NUMBER 	Инструм. абразивный
Прибор контр шир зуба резьбы TW- NUMBER -М	Инструм. мерительный
Манжета армир  NUMBER . NUMBER - NUMBER х NUMBER х NUMBER  ГОСТ  NUMBER - NUMBER 	ИзделияРезино-технич
Пластина опорная С NUMBER 	Сплав твердый
Смазка ПОЛИТРЕН Э- NUMBER 	Смазки
Гайка М NUMBER  А NUMBER  DIN NUMBER 	Метизы
Комплект ремонтный Sic  NUMBER 	Запчасти
Головка внутришлифовальная  NUMBER . NUMBER Х NUMBER А	Инструменты
Фреза отрезная  NUMBER х NUMBER , NUMBER 	Фрезы
Шаблон-линейка ЭИ  NUMBER . NUMBER . NUMBER  СБ- NUMBER  ф NUMBER 	Инструм. мерительный
Подшипник  NUMBER 	Подшипники
Капсула пневмопочты NW NUMBER K  NUMBER х NUMBER х NUMBER , NUMBER 	Посуда и приборы хим
Цилиндр подъема стрелы прав  NUMBER - NUMBER 	З/Ч ТракСтроитТехн
Конденсатор К NUMBER - NUMBER   NUMBER в  NUMBER мкф	Конденсаторы
Эл двиг  NUMBER АИ NUMBER М NUMBER   NUMBER квт  NUMBER об/м	Электродвигатели
РВД  NUMBER - NUMBER -AOS. NUMBER /AOS-M NUMBER x NUMBER /M NUMBER x NUMBER - NUMBER 	Запчасти
Маркер меловой промышленный высокотемпер	Посуда и приборы хим
Набор уплотнений к TMA NUMBER   NUMBER  EMAG	Запчасти
Компрессор ZR  NUMBER  K NUMBER E-TFD- NUMBER 	Запчасти
Кран водоразборный ДУ NUMBER 	Хоз.товары
Уплотнение S NUMBER -M  NUMBER х NUMBER х NUMBER  PU NUMBER /PA	Запчасти
Цилиндр сцеплен гл  NUMBER - NUMBER - NUMBER  КАМАЗ	З/Ч АвтомобПромышл
Провод монтажн МГШВ-Б  NUMBER х NUMBER , NUMBER 	Кабельно-проводников
Вал ч.Р- NUMBER 	Запчасти
Светильник РСП- NUMBER - NUMBER - NUMBER 	СветотехнИсточнСвета
Подушка двигателя УАЗ	З/Ч АвтомобПромышл
Отвертка диэлектрическая плос  NUMBER х NUMBER 	Инструменты
Болт М NUMBER х NUMBER  ГОСТ NUMBER - NUMBER 	Метизы
Ремень подбородочный текст для каски	ИзделияРезино-технич
Труба нержавеющая ф NUMBER х NUMBER  ст NUMBER - NUMBER х NUMBER н NUMBER т	Металлопрокат
Пластина тв спл опорная  NUMBER - NUMBER 	Сплав твердый
Трифенилтетразолий  NUMBER - NUMBER - NUMBER  хлористый	Химпродукция
Шайба пружинная  NUMBER  ГОСТ NUMBER - NUMBER 	Метизы
Пластина тв спл SNMM  NUMBER -MR  NUMBER 	Сплав твердый
Подшипник НМ NUMBER -НМ NUMBER CD-HTCS	Запчасти
Контактор КМИ- NUMBER  кат  NUMBER В  NUMBER A IP  NUMBER 	Контакторы
Подшипник  NUMBER 	Подшипники
Провод сетевой ПВС  NUMBER х NUMBER , NUMBER 	Кабельно-проводников
Ремень приводной  NUMBER Л NUMBER 	ИзделияРезино-технич
Источник беспер пит Smart-UPS  NUMBER VA	ВычОргТехн и З/Ч
Вставка кулачка ч. NUMBER 	Запчасти
Долото канавочное SDS  NUMBER Х NUMBER 	Сверла
Кольцо упорное А  NUMBER  прицеп СЗАП  NUMBER 	ИздИзПолимеровСтанд
Шпатель  NUMBER мм	Запчасти
Шпиндель ч.ABDAG NUMBER   NUMBER 	Запчасти
Контактор  NUMBER RT NUMBER - NUMBER AP NUMBER 	Контакторы
Отвод  NUMBER - NUMBER х NUMBER  ст NUMBER 	Арматура к трубам
Комплект вклад шат  NUMBER В ЯМЗ NUMBER   NUMBER ед	З/Ч АвтомобПромышл
Насос водяной  NUMBER - NUMBER  КАМАЗ	З/Ч АвтомобПромышл
Картридж HP LJ  NUMBER  Q NUMBER A Black	Расходные материалы
Манжета в сб прив ТНВД  NUMBER . NUMBER  КАМАЗ	З/Ч АвтомобПромышл
Элемент фильтр  NUMBER . NUMBER . NUMBER . NUMBER . NUMBER  DN NUMBER BOLL	Запчасти
Шкаф  NUMBER -х створчатый	КонтрИзмеритПриборы
"Шина  NUMBER . NUMBER - NUMBER  ВЛ- NUMBER  ""Волтайр"" нс NUMBER "	Запчасти
Смазка Mobil Unirex N  NUMBER 	Смазки
Рельс MR-S- NUMBER -N-G NUMBER -KC-R NUMBER - NUMBER -CN	Запчасти
Масло GRAGO P.N.	Запчасти
Препарат для чистки контактов Cleaner	Хоз.товары
Одеяло Fiberfrax  NUMBER кг/м NUMBER   NUMBER х NUMBER х NUMBER 	Теплоизоляционные
Конденсатор К NUMBER - NUMBER   NUMBER в  NUMBER мкф	Конденсаторы
Гайка бронз Н NUMBER - NUMBER - NUMBER  ТПЦ- NUMBER 	З/Ч по чертежам
Насос  NUMBER  DD  NUMBER . NUMBER   NUMBER m NUMBER /h  NUMBER m TMP	Насосы
Пластина тв спл С/ NUMBER  Lp NUMBER 	Сплав твердый
ТхдОН ГОСТ NUMBER   NUMBER   NUMBER   NUMBER 	Трубы
Отвод  NUMBER - NUMBER х NUMBER  ст NUMBER 	Арматура к трубам
Стекло жидкое	Стройматериалы
Кран шаров муфт сталь Ду NUMBER  Ру NUMBER 	АрматураТрубопровод
Втулка защитная Н NUMBER . NUMBER . NUMBER . NUMBER . NUMBER  насоса	Запчасти
Подшипник задней ступицы внут  NUMBER  КАМАЗ	З/Ч АвтомобПромышл
Ствол пожарный РС- NUMBER . NUMBER 	ОборПожарныйИнвен
Отвертка с прямым шлицем  NUMBER х NUMBER , NUMBER 	Инструмент слесарный
Фреза отрезная  NUMBER х NUMBER , NUMBER 	Фрезы
Ключ накидной искробез  NUMBER х NUMBER  USAG	Инструмент слесарный
Гайка М NUMBER   NUMBER . NUMBER  ГОСТ NUMBER - NUMBER 	Метизы
Губка для муфты ч. NUMBER . NUMBER . NUMBER - NUMBER -А	Запчасти
Заглушка полиэтиленовая ф NUMBER х NUMBER , NUMBER 	ИздДляТрубПредохран
Палец ч.Р- NUMBER 	Запчасти
Трубка электромонтажная ХВТ ф NUMBER 	Стройматериалы
Подсоединение к бачку унитаза гибкое	Хоз.товары
Кран шаровой  NUMBER б NUMBER п NUMBER  Ду  NUMBER 	Запчасти
Зажим DIN NUMBER  SPAL  NUMBER  PP DPAL-AS M W NUMBER 	З/Ч по чертежам
Рым-болт М NUMBER  DIN NUMBER 	З/Ч ГрузПодъемОборуд
Ролик рольганга ч.Э- NUMBER . NUMBER . NUMBER - NUMBER 	Запчасти
Наконечник изолир кольцевой НКИ  NUMBER , NUMBER - NUMBER 	Изделия электроустан
Подшипник  NUMBER  К NUMBER 	Запчасти
Подшипник  NUMBER - NUMBER А	Запчасти
Сверло спиральное ц/х  NUMBER , NUMBER 	Сверла
Манжета армир.  NUMBER . NUMBER - NUMBER х NUMBER - NUMBER 	Запчасти
Стенкомер С- NUMBER   NUMBER - NUMBER  мм  NUMBER , NUMBER 	Инструм. мерительный
Кабель силовой гибкий КГ  NUMBER х NUMBER 	Кабельно-проводников
Прессшайба  NUMBER . NUMBER . NUMBER А- NUMBER 	Запчасти
Петля дверная лев	Хоз.товары
Вал ч.Д  NUMBER - NUMBER 	Запчасти
Стакан погружной RI- NUMBER v NUMBER SES NUMBER 	Огнеупоры
Подшипник  NUMBER  Н	Запчасти
Розетка скрыт пров  NUMBER гнез с заз конт	Изделия электроустан
Чашка дифференц левая  NUMBER - NUMBER  КАМАЗ	З/Ч АвтомобПромышл
Контактор КТ- NUMBER  кат  NUMBER в	Контакторы
Подшипник  NUMBER E	Подшипники
Блок резисторов Б NUMBER -У NUMBER  ИРАК NUMBER . NUMBER . NUMBER - NUMBER 	Запчасти
Запчасть к клейм машине б/у к-т	З/Ч к компрессорам
Пост кнопочный ПКУ NUMBER - NUMBER - NUMBER - NUMBER 	КнопкиПостыУправлен
Шнур резиновый  NUMBER - NUMBER С  NUMBER мм	ИзделияРезино-технич
Шестерня  NUMBER . NUMBER - NUMBER - NUMBER Б ТПЦ- NUMBER 	З/Ч по чертежам
Эл двиг АИР NUMBER S NUMBER   NUMBER кВт  NUMBER об/мин  NUMBER 	Электродвигатели
Штифт ч.Э- NUMBER - NUMBER 	Запчасти
Болт М NUMBER х NUMBER   NUMBER . NUMBER  ГОСТ Р NUMBER - NUMBER 	Метизы
Подшипник GEG  NUMBER  ES	Запчасти
Ключ накидной искробез  NUMBER х NUMBER  USAG	Инструмент слесарный
Круг шлиф ПП  NUMBER х NUMBER х NUMBER   NUMBER А F NUMBER  K,L V	Инструм. абразивный
Втулка ч.Ф NUMBER . NUMBER . NUMBER 	Запчасти
Реле времени PCR- NUMBER   NUMBER В на DIN-рейку	Запчасти
Пила ленточная б/м Х NUMBER   NUMBER х NUMBER х NUMBER , NUMBER х NUMBER / NUMBER 	Пилы
Плашка М NUMBER х NUMBER , NUMBER 	Инструмент режущий
Сверло спиральное ц/х  NUMBER , NUMBER 	Сверла
ШВП ч. NUMBER  по оси Х  NUMBER 	Запчасти
Термопара  NUMBER / NUMBER - NUMBER - NUMBER - NUMBER - NUMBER 	КонтрИзмеритПриборы
Колесо неповоротное большегруз арт NUMBER 	З/Ч ГрузПодъемОборуд
Бумага дисковая диаграммная  NUMBER 	ПродукцЦеллюлозБумаж
Подшипник  NUMBER  ГОСТ  NUMBER - NUMBER 	Подшипники
Блок монтажный Гп Б  NUMBER , NUMBER - NUMBER ( NUMBER )	З/Ч ГрузПодъемОборуд
Соединение прямое F  NUMBER -S	Запчасти
'Монитор  NUMBER '' Samsung SMT- NUMBER 	КонтрИзмеритПриборы
Аммоний уксуснокислый (ацетат) хч	Химпродукция
Сверло спиральное к/х  NUMBER , NUMBER 	Сверла
Смесь сырьевых материалов для ЭСГ- NUMBER / NUMBER 	ХимПродОбщехимНазн
Материал углеродсодер.УСМ- NUMBER А фр  NUMBER - NUMBER 	Материалы вспом-е
Болт М NUMBER х NUMBER  ГОСТ NUMBER - NUMBER 	Метизы
Бурт ПВДФ ф NUMBER  Ду NUMBER  Pу NUMBER 	ИздИзПолимеровСтанд
Краска эмаль ПФ- NUMBER  бежевая	Стройматериалы
Цепь  NUMBER - NUMBER  СБ ТПЦ- NUMBER 	Цепи и звенья
Оргстекло лист  NUMBER мм	ИздИзПолимеровСтанд
Профиль Sika Swell P- NUMBER M рулонный	Стройматериалы
Пластина техническая  NUMBER - NUMBER мм	ИзделияРезино-технич
Уплотнение поршня К NUMBER -Р  NUMBER х NUMBER х NUMBER  H-PU	ИздИзПолимерПоЧертеж
Соединение прямое штуцерное A  NUMBER -RS/WD	Запчасти
Соединение резьбовое A- NUMBER -RS/WD	Запчасти
Заглушка п/эт ф NUMBER х NUMBER 	ИздДляТрубПредохран
Стакан ч.Р- NUMBER - NUMBER 	Запчасти
Колба КП- NUMBER - NUMBER  ТС	Посуда и приборы хим
Блокировка VЕM NUMBER  AF NUMBER -AF NUMBER  ABB	Запчасти
Заглушка полиэтиленовая ф NUMBER х NUMBER 	ИздДляТрубПредохран
Смазка TOTAL JET MARINE	Смазки
Пила горячей резки  NUMBER   NUMBER  зубов	Пилы
Уплотнение торцев БО- NUMBER С к НКВ  NUMBER / NUMBER 	ИздИзПолимерПоЧертеж
Заглушка полиэтиленовая ф NUMBER х NUMBER 	ИздДляТрубПредохран
Редуктор Ц NUMBER - NUMBER - NUMBER - NUMBER -ЦУ NUMBER  ТУ NUMBER - NUMBER - NUMBER - NUMBER 	Запчасти
Вал выходной ч.Р- NUMBER 	Запчасти
Фильтр IFZ NUMBER  IFS	ДатчСистемАвтоматики
Мера твердости Бинелля HBW NUMBER   NUMBER / NUMBER / NUMBER 	Инструм. мерительный
Заглушка полиэтиленовая ф NUMBER х NUMBER 	ИздДляТрубПредохран
Вентилятор Ansaldo радиальный ELP NUMBER 	Запчасти
Уплотнение поршня К NUMBER -R  NUMBER x NUMBER x NUMBER  Rub NUMBER 	Запчасти
Колесо зубчатое  NUMBER L NUMBER . NUMBER  ТПЦ- NUMBER 	З/Ч по чертежам
Роликоопора холостая ф NUMBER , NUMBER хEL= NUMBER № NUMBER # NUMBER 	Запчасти
Ключ рожковый  NUMBER х NUMBER   NUMBER  Gedore	Инструмент слесарный
Затвор дисковый V-KN NUMBER -G NUMBER N NUMBER DN NUMBER  PN NUMBER 	Запчасти
Крышка ч.Р- NUMBER - NUMBER 	Запчасти
Шпилька М NUMBER - NUMBER gх NUMBER . NUMBER  ГОСТ NUMBER - NUMBER 	Метизы
Сальник ступицы задний ГАЗ  NUMBER 	З/Ч АвтомобПромышл
Болт М NUMBER х NUMBER  ГОСТ NUMBER - NUMBER 	Метизы
Комбинация прибор  NUMBER  КАМАЗ	З/Ч АвтомобПромышл
Смесь сырьевых материал для ЭСП- NUMBER А	ХимПродОбщехимНазн
Кабель силовой ВВГ  NUMBER х NUMBER , NUMBER 	Кабельно-проводников
Ключ гаечный омедненный  NUMBER х NUMBER 	Инструмент слесарный
Колесо зубчатое ч. NUMBER А	Запчасти
Кольцо упл.рад.  NUMBER х NUMBER х NUMBER  B NUMBER  Simrit	З/Ч ТракСтроитТехн
Вал  NUMBER L NUMBER . NUMBER  ТПЦ- NUMBER 	З/Ч по чертежам
Кирпич MK NUMBER / NUMBER  RI-MC NUMBER LC	Огнеупоры
Компенсатор ч.Э- NUMBER -ТХ NUMBER  поз. NUMBER 	Запчасти
Прокладка резиновая МБС  NUMBER - NUMBER 	ИзделияРезино-технич
Контроллер для светодиодного дюралайта	Изделия электроустан
Планка верхняя латунная  NUMBER - NUMBER  ТПЦ- NUMBER 	З/Ч по чертежам
Ось  NUMBER L NUMBER . NUMBER  ТПЦ- NUMBER 	З/Ч по чертежам
Редуктор PHD NUMBER R NUMBER -LBB- NUMBER  Sumitomo	Редукторы
Оправка FI-MVK- NUMBER S-PRC-W NUMBER 	Инструмент слесарный
Знак дорожн. ограничение по ширине  NUMBER  м	ХозИнвентарь
Удленитель опр. PQF  NUMBER - NUMBER . NUMBER - NUMBER 	Инструменты
Затвор диск  NUMBER -х эксц Ду NUMBER  Ру NUMBER   NUMBER  ед	АрматураТрубопровод
Подставка сварщика для ног	ХозИнвентарь
Колба мерная  NUMBER - NUMBER - NUMBER 	Посуда и приборы хим
Гидротолкатель HYD. NUMBER / NUMBER 	Запчасти
НасосAA NUMBER VSO NUMBER DRG/ NUMBER R-PPB NUMBER N NUMBER R NUMBER 	Насосы
'Замок быстросъемный Камлок А DN NUMBER '' S/S	ИнстОснастТехнПоЧерт
Сальник кр подш втор вала  NUMBER х NUMBER   NUMBER -П	З/Ч ТракСтроитТехн
Нефтепродукты ГСО	Посуда и приборы хим
Соединитель изолир SMOE- NUMBER 	Изделия электроустан
Датчик ВБИ-П NUMBER - NUMBER К- NUMBER -З	Запчасти
Эмаль ПФ- NUMBER  светло-зеленая ГОСТ  NUMBER - NUMBER 	Прод.Лако-красочная
Гайка Н NUMBER - NUMBER - NUMBER - NUMBER  ТПЦ- NUMBER 	З/Ч по чертежам
Реле SHUNT OPEN.RELE ASE  NUMBER SDA NUMBER R NUMBER 	Запчасти
Круг шлиф ПП  NUMBER х NUMBER х NUMBER   NUMBER А  NUMBER  СМ NUMBER 	Инструм. абразивный
Шпилька ч. NUMBER - NUMBER 	Запчасти
Подшипник  NUMBER 	Подшипники
Манометр ТМ- NUMBER Р. NUMBER  ( NUMBER - NUMBER , NUMBER МПа) М NUMBER х NUMBER , NUMBER 	КонтрИзмеритПриборы
Механизм исполнит МЭОФ  NUMBER / NUMBER - NUMBER , NUMBER Р- NUMBER  У NUMBER 	Запчасти
Термометр биметал БТ- NUMBER х NUMBER 	КонтрИзмеритПриборы
Круг  NUMBER  ст NUMBER 	ПрокатСортовойОбНазн
Ткань х/б марля отбеленная	ИзделияРезино-технич
Пластина резьбовая  NUMBER . NUMBER  ASC  NUMBER 	Сплав твердый
"Клеймо тв спл  NUMBER "" NUMBER "" ВК NUMBER "	Инструменты
Набор пробных очковых линз Armed  NUMBER 	З/Ч Пневмооборудов
Насос вакуумный COBRA NC  NUMBER  B	Насосы
Автомат АВ NUMBER М NUMBER -СВ  NUMBER а	Запчасти
Сверло спиральное к/х  NUMBER , NUMBER 	Сверла
Клапан редукционный  NUMBER  КАМАЗ	З/Ч АвтомобПромышл
Блок питания БП  NUMBER Б-Д NUMBER - NUMBER С	Блоки систем автомат
Плашка метрической резьбы М NUMBER 	Инструменты
Сепаратор плоский BF NUMBER / NUMBER 	Запчасти
Резец расточной для скв отв  NUMBER х NUMBER  Т NUMBER К NUMBER 	Резцы
Фильтроэлемент SE- NUMBER G NUMBER B/ NUMBER  STAUFF	Запчасти
Подшипник  NUMBER  (NJ NUMBER )	Подшипники
"Клеймо тв спл  NUMBER ""А"" ВК NUMBER "	Инструменты
Резец проходной отогнутый  NUMBER х NUMBER  Т NUMBER К NUMBER 	Резцы
Кабель нагревательный TASH  NUMBER 	Кабельная продукция
Переходник резьбоой RI NUMBER / NUMBER Х NUMBER / NUMBER CFX	Огнеупоры
Пластина тв спл  NUMBER  ВК NUMBER 	Сплав твердый
Подшипник  NUMBER  ( NUMBER  Z)	Подшипники
Сверло тв спл  NUMBER , NUMBER 	Сверла
Платик ч.НР NUMBER . NUMBER . NUMBER . NUMBER 	Запчасти
Накопитель Usb Flash Drive  NUMBER Gb	ВычОргТехн и З/Ч
Резина Kerabutyl WBC  NUMBER мм STEULER-KCH	ИзделияРезино-технич
Гидротолкатель ЭГТ NUMBER У NUMBER 	Запчасти
Круг  NUMBER  ст NUMBER ХГТ	ПрокатСортовойОбНазн
Клапан Z NUMBER FS NUMBER -  NUMBER - NUMBER X/ NUMBER QV	Запчасти
Подшипник  NUMBER  ( NUMBER )	Подшипники
Прокладка ф NUMBER  Ду NUMBER  EPDM	ИздИзПолимеровСтанд
Набор отверток  NUMBER RTX/S NUMBER   NUMBER шт TORX Beta	Инструмент слесарный
Брошюра А NUMBER  спец. заказ  NUMBER  листов	Канцтовары
Паронит ПОН  NUMBER , NUMBER 	Издел.Асбесто-технич
Труба ПВДФ ф NUMBER х NUMBER , NUMBER  Pу NUMBER  гладкая	ИздИзПолимеровСтанд
Кольцо ч. NUMBER . NUMBER . NUMBER 	Запчасти
Набивка ХБП- NUMBER   NUMBER мм	ИздДляТрубПредохран
Опора полипропиленовая Ф NUMBER мм	ИздИзПолимеровСтанд
Подшипник  NUMBER - NUMBER АК NUMBER С NUMBER 	Запчасти
Строп УСК NUMBER - NUMBER , NUMBER т L- NUMBER мм	Запчасти
Трубка фторопластовая Ф NUMBER Д  NUMBER , NUMBER х NUMBER , NUMBER 	Изделия электроустан
Кольцо  NUMBER , NUMBER х NUMBER , NUMBER  NBR  NUMBER 	ИздИзПолимеровСтанд
Растворитель CL-KES NUMBER   NUMBER л	Химпродукция
Болт М NUMBER х NUMBER  ГОСТ NUMBER - NUMBER 	Метизы
Корпус задней головки ч. NUMBER -Г	Запчасти
Винт  NUMBER х NUMBER  ГОСТ NUMBER - NUMBER (DIN  NUMBER )	Метизы
Надфиль круглый  NUMBER  № NUMBER 	Инструмент слесарный
Уплотнение А NUMBER -А  NUMBER х NUMBER х NUMBER / NUMBER  PUR	Запчасти
Корпус клапана ч.Р- NUMBER 	Запчасти
Перфоратор электр HR NUMBER C Makita	Инстр. электрический
Кольцо врезное D NUMBER   NUMBER - NUMBER - NUMBER  Lincoln	Метизы
Штатив универсальный S NUMBER -Z	Метизы
Болт М NUMBER х NUMBER 	Метизы
Винт высокопр с цил. гол. М NUMBER х NUMBER  кл. NUMBER . NUMBER 	Метизы
Пневмоцилиндр CS NUMBER TN NUMBER - NUMBER -XC NUMBER ( NUMBER ) NUMBER / NUMBER 	З/Ч Пневмооборудов
Смазка Экстраконт	Смазки
Паронит ПМБ  NUMBER , NUMBER 	Издел.Асбесто-технич
"Американка нарр.  NUMBER х NUMBER / NUMBER """	Стройматериалы
Подшипник NUTR NUMBER A	Подшипники
Бахилы защитные низкие	СИЗ (без размеров)
Кольцо R NUMBER   NUMBER , NUMBER x NUMBER , NUMBER  NBR	Запчасти
Муфта предохранительная ч.В NUMBER - NUMBER СБ	Запчасти
Уплотнен К NUMBER -Р  NUMBER х NUMBER х NUMBER х NUMBER х NUMBER  Pur/Tal	ИздИзПолимерПоЧертеж
Муфта полипроп разборная НР Ф NUMBER   NUMBER / NUMBER 	ИздИзПолимеровСтанд
Баллон г/аккумулят SB NUMBER - NUMBER A NUMBER / NUMBER А NUMBER - NUMBER A	Запчасти
Манжета коленвала  NUMBER х NUMBER  МАЗ	З/Ч АвтомобПромышл
Шина MAKITA	Запчасти
Клапан обр кис ДОНМЕТ  NUMBER . NUMBER . NUMBER  М NUMBER х NUMBER , NUMBER 	АрматураТрубопровод
Выключатель авт. Э NUMBER В  NUMBER А прив.эл.маг.	Запчасти
Вал Н NUMBER . NUMBER . NUMBER . NUMBER . NUMBER  насоса	Запчасти
Глицерин чда	РеактивыХимич.
Подшипник  NUMBER  (N NUMBER )	Подшипники
Фланец вып отв  NUMBER . NUMBER . NUMBER . NUMBER СБ ЭСПЦ	З/Ч по чертежам
Клапан контрольный B NUMBER -B Bronx	З/Ч Гидрооборудован
Колесо зубчатое  NUMBER L NUMBER . NUMBER  ТПЦ- NUMBER 	З/Ч по чертежам
Болт М NUMBER х NUMBER  ГОСТ NUMBER - NUMBER 	Метизы
Пластина тв спл DNMM  NUMBER -PR  NUMBER 	Сплав твердый
Манжета  NUMBER L NUMBER  ТПЦ- NUMBER 	ИздИзПолимерПоЧертеж
Шплинт  NUMBER , NUMBER х NUMBER , NUMBER  ГОСТ NUMBER - NUMBER 	Метизы
Конденсатор К NUMBER - NUMBER   NUMBER в  NUMBER мкф  NUMBER С	Конденсаторы
Комплект роликов XeroxWC NUMBER   NUMBER ,  NUMBER лот  NUMBER ед	ВычОргТехн и З/Ч
Напильник круглый  NUMBER  № NUMBER 	Инструменты
Плита ВА- NUMBER / NUMBER /М/ NUMBER -АL Atos	З/Ч Гидрооборудован
Ножницы арматурные до  NUMBER  мм	Инструмент слесарный
Набивка Графлекс безасбест Н  NUMBER   NUMBER х NUMBER 	Издел.Асбесто-технич
Гайка М NUMBER  оц DIN NUMBER 	Метизы
Подшипник  NUMBER  АС NUMBER 	Запчасти
Сетка сварная  NUMBER х NUMBER х NUMBER 	МеталлопрокатЦветной
Наконечник-гильза E NUMBER   NUMBER , NUMBER мм NUMBER   NUMBER шт	Изделия электроустан
Ключ гаечный КГД  NUMBER х NUMBER 	Инструмент слесарный
Бур к перфоратору SDS+  NUMBER х NUMBER / NUMBER 	Сверла
Рекуператор ч. NUMBER -Б СБ	Запчасти
Ремкомплект ТНВД NUMBER - NUMBER - NUMBER КАМАЗ  NUMBER ед	З/Ч АвтомобПромышл
Подшипник  NUMBER - NUMBER Z SKF	Подшипники
Отвод  NUMBER - NUMBER х NUMBER  ст NUMBER 	Арматура к трубам
Кулачок  NUMBER . NUMBER . NUMBER . NUMBER А- NUMBER 	Резцы
Кран букса червячная КБР- NUMBER 	Запчасти
Кабель КГ  NUMBER х NUMBER , NUMBER 	Кабельная продукция
Вал ведущ в сб  NUMBER ЕВ NUMBER  погр FD NUMBER  T NUMBER 	З/Ч АвтомобПромышл
Набор ключей шестигран с шаром  NUMBER шт ДТ	Инструмент слесарный
Кирпич периклазоуглерод ПУ- NUMBER  N NUMBER / NUMBER 	Периклазоуглеродисты
Втулка ч.НР NUMBER . NUMBER . NUMBER . NUMBER 	Запчасти
Строп стал канат УСК NUMBER - NUMBER , NUMBER / NUMBER 	Стропы
Плата М NUMBER - NUMBER   NUMBER СК	КонтрИзмеритПриборы
Подшипник  NUMBER  ( NUMBER )	Подшипники
Лента стеклобандажная ЛСБЭ- NUMBER 	ОборудБытовое
Направляющая бронз  NUMBER L NUMBER . NUMBER  ТПЦ- NUMBER 	З/Ч по чертежам
Наконечник рул пр  NUMBER К NUMBER HYUNDAI HD NUMBER 	З/Ч АвтомобПромышл
Кольцо  NUMBER , NUMBER х NUMBER , NUMBER  NBR NUMBER 	ИздИзПолимеровСтанд
Подшипник  NUMBER  ( NUMBER )	Подшипники
Фильтр обезз белая лента ф NUMBER , NUMBER 	РеактивыХимич.
Пила сегментная  NUMBER х NUMBER  Z NUMBER  Lennartz	Инструменты
Ролик UK. NUMBER . NUMBER . NUMBER . NUMBER 	З/Ч по чертежам
Уплотнение A NUMBER -A  NUMBER x NUMBER x NUMBER / NUMBER  Ecopur	Запчасти
Колодка с крепежным носителем RUZ- NUMBER A	Реле
Вал БТС NUMBER . NUMBER А. NUMBER  ТПЦ- NUMBER 	З/Ч по чертежам
Стакан ковшевой RI- NUMBER IN NUMBER 	Огнеупоры
Блок колесный JT NUMBER . NUMBER . NUMBER . NUMBER . NUMBER 	Запчасти
Респиратор  NUMBER   NUMBER М VFLEX	ХозИнвентарь
Датчик давл масл ММ- NUMBER   NUMBER  КАМАЗ	З/Ч АвтомобПромышл
Ремень SPZ- NUMBER 	Запчасти
Фреза пазовая затыл  NUMBER х NUMBER 	Фрезы
Сталь оцинкованная рулон  NUMBER , NUMBER - NUMBER , NUMBER х NUMBER 	Металлопрокат
Пылесос Дастпром ПП- NUMBER / NUMBER . NUMBER - NUMBER -С NUMBER 	ОборуТехнологическое
Клапан ZDB  NUMBER  VP NUMBER - NUMBER X/ NUMBER V S NUMBER  R NUMBER 	З/Ч Гидрооборудован
Осушитель  NUMBER - NUMBER  КАМАЗ	З/Ч АвтомобПромышл
Мера конц № NUMBER  кл NUMBER  ГОСТ NUMBER  BC, LC, SC, NU	Инструм. мерительный
Железо (III) хлорид  NUMBER -водный хч	Материалы лаб.
Автомат  NUMBER SX NUMBER - NUMBER  SIЕMENS	ВыключатАвтоматич
Подшипник SY NUMBER TF	Подшипники
Круг  NUMBER  ст NUMBER 	ПрокатСортовойОбНазн
Манометр цифровой SPG-DIGI-B NUMBER B	КонтрИзмеритПриборы
Наделка ч. NUMBER - NUMBER . NUMBER / NUMBER 	Запчасти
Круг из чепрака ф NUMBER х NUMBER 	Инструменты
Круг отрезной  NUMBER х NUMBER х NUMBER   NUMBER А  NUMBER  Т	Инструм. абразивный
Трубка вакуумная  NUMBER , NUMBER х NUMBER , NUMBER  ГОСТ NUMBER - NUMBER 	Насосы
Подшипник  NUMBER KEJW NUMBER +Н NUMBER 	Запчасти
Пила ленточная б/м М NUMBER   NUMBER х NUMBER х NUMBER , NUMBER х NUMBER / NUMBER 	Пилы
Уплотнение S NUMBER -P  NUMBER x NUMBER x NUMBER  Ecopur	Запчасти
Крепление DINрейки однофаз.GDH  NUMBER х NUMBER х NUMBER 	Метизы
Лампа люминесц. FL  NUMBER W/ NUMBER 	Комплектующие электр
Кусачки для  NUMBER в ProsKit РМ- NUMBER 	Инструм. абразивный
Система электродов к АС- NUMBER   NUMBER М NUMBER . NUMBER . NUMBER 	ОборуТехнологическое
Подшипник  NUMBER  FAG	Подшипники
Строп стал канат УСК NUMBER - NUMBER , NUMBER / NUMBER 	Стропы
Модуль интерфейс  NUMBER ES NUMBER - NUMBER MA NUMBER 	МодулПлатыСистАвтом
Пластина резьбовая  NUMBER RL- NUMBER MM NUMBER A NUMBER M NUMBER 	Сплав твердый
Брошюра А NUMBER   NUMBER - NUMBER  листов	Канцтовары
Рама для дефектоскопа ч.В- NUMBER - NUMBER СБизм NUMBER 	КонтрИзмеритПриборы
Кабель NYY-J  NUMBER х NUMBER  +  NUMBER x NUMBER 	Кабельная продукция
Кран шаров муфт сталь Ду NUMBER  Ру NUMBER 	АрматураТрубопровод
Устройство МФУ Kyocera FS-C NUMBER MFP	Блоки систем автомат
Подшипник  NUMBER  Н ( NUMBER  W NUMBER )	Запчасти
Надфиль трехгранный  NUMBER  № NUMBER 	Инструмент слесарный
Знак дорожн. ограничение по ширине  NUMBER , NUMBER  м	ХозИнвентарь
Сервер DL NUMBER G NUMBER  X NUMBER   NUMBER x NUMBER . NUMBER GB  NUMBER x NUMBER GB	Запчасти
Канат стальной о/н Ду  NUMBER , NUMBER  тип ЛК-РО	Метизы
Резец отрезной  NUMBER х NUMBER  Т NUMBER К NUMBER 	Резцы
Подшипник  NUMBER  ( NUMBER ) FAG	Подшипники
Профиль монтажный К NUMBER  цУТ NUMBER , NUMBER   NUMBER м	Изделия электроустан
Сверло спиральное к/х  NUMBER , NUMBER 	Сверла
Развертка ручная  NUMBER , NUMBER 	Масла фасовочные
Муфта полипроп разборная НР Ф NUMBER   NUMBER / NUMBER 	ИздИзПолимеровСтанд
Костюм камуфляжный утепленн к-т  NUMBER ед СБ	Спецодежда
Реле РТ- NUMBER / NUMBER А ТУ NUMBER - NUMBER . NUMBER - NUMBER 	Запчасти
Уплотнение штока S NUMBER   NUMBER х NUMBER х NUMBER 	ИздИзПолимерПоЧертеж
Дюбель-гвоздь  NUMBER Х NUMBER 	Метизы
Контактор МК  NUMBER - NUMBER УХЛЗ	Запчасти
Лист  NUMBER х NUMBER х NUMBER  стХН NUMBER Ю	ПрокатЛистовойЛисты
Отвод  NUMBER - NUMBER х NUMBER  ст NUMBER Х NUMBER Н NUMBER Т	Арматура к трубам
Винт  NUMBER х NUMBER  ГОСТ NUMBER - NUMBER (DIN  NUMBER )	Метизы
Датчик индуктивный ВБИ-М NUMBER - NUMBER У- NUMBER - NUMBER 	ДатчСистемАвтоматики
Насос водУМЗ NUMBER - NUMBER - NUMBER Газель бизнес	Насосы
Выключатель ВВЭ-М- NUMBER - NUMBER / NUMBER 	Запчасти
Хомут  NUMBER '' SC-RK NUMBER   NUMBER -х болт,  NUMBER мм алюм	Запчасти
Мера установочная FSTD-BCSG- NUMBER B- NUMBER -P	ОборудПрочее
Наконечник вилочный НВИ  NUMBER . NUMBER - NUMBER 	Изделия электроустан
Фреза отрезная  NUMBER х NUMBER , NUMBER 	Фрезы
Лист  NUMBER  ст NUMBER Х NUMBER Н NUMBER Т	ПрокатЛистовойЛисты
Кольцо  NUMBER , NUMBER х NUMBER , NUMBER  NBR NUMBER 	ИздИзПолимеровСтанд
Клей Cosmofen CA NUMBER  цианакрилатный ( NUMBER г)	ОборуТехнологическое
Кальций углекислый	Стройматериалы
Кабель контрольный КВВБГ  NUMBER Х NUMBER 	Запчасти
Аккумулятор SF  NUMBER   NUMBER , NUMBER Ah	Запчасти
Мотор-редуктор HU  NUMBER A  NUMBER A  NUMBER - NUMBER E-TH-TF	Редукторы
Резец расточной для скв отв  NUMBER х NUMBER  Т NUMBER К NUMBER 	Резцы
Болт М NUMBER х NUMBER  оцинкованный	Метизы
Моноэтиленгликоль	РеактивыХимич.
ШВП BTK NUMBER V- NUMBER . NUMBER QZWW+ NUMBER LC NUMBER T-J NUMBER K	Запчасти
Пружина возврTrailorSA NUMBER / NUMBER Sampa СЗАП	ОборуТехнологическое
Подшипник  NUMBER  КАМАЗ	З/Ч АвтомобПромышл
Реле  NUMBER . NUMBER . NUMBER . NUMBER . NUMBER . NUMBER  Finder	Запчасти
Подшипник NU  NUMBER / NUMBER  EW NUMBER C NUMBER 	Подшипники
ГСО  NUMBER - NUMBER 	Химпродукция
Преобразователь ультразв. П NUMBER - NUMBER , NUMBER П- NUMBER 	Запчасти
Колесо крановое приводное ч. NUMBER . NUMBER .T	Запчасти
Доска флипчарт	Хоз.товары
Картридж гол для плот HP DSJT  NUMBER  син NUMBER 	ВычОргТехн и З/Ч
Устройство УПНС-М  NUMBER В	ИзделияРезино-технич
Кирпич SYNCARBON C S NUMBER T NUMBER   NUMBER / NUMBER 	Огнеупоры
Винт  NUMBER х NUMBER  ГОСТ NUMBER - NUMBER (DIN  NUMBER )	Метизы
Эл двиг  NUMBER LA NUMBER - NUMBER АА NUMBER   NUMBER М  NUMBER кВт NUMBER о/м	Электродвигатели
Форсунка  NUMBER . NUMBER .T NUMBER .CC	ИнстОснастТехнПоЧерт
Прокладка коллект NUMBER - NUMBER УМЗ-А NUMBER  ГАЗ	З/Ч АвтомобПромышл
Лестница  NUMBER х NUMBER   NUMBER / NUMBER  см	Хоз.товары
Профиль направляющий  NUMBER х NUMBER  L NUMBER 	З/Ч кМеталлообОборуд
Колесо насоса NK NUMBER - NUMBER NAT BAQE NUMBER 	Запчасти
Комплект патрубков отопит н/о ГАЗЕЛЬ  NUMBER ед	З/Ч АвтомобПромышл
Плоскогубцы многоцелевые  NUMBER  Gedore	Инструмент слесарный
Смесь сырьевых материалов ЭСП- NUMBER А	ХимПродОбщехимНазн
Заглушка LAN  NUMBER x NUMBER   NUMBER  ДКС	Запчасти
Ось ч.В- NUMBER 	Запчасти
Термопреобразователь ТПУ  NUMBER /М NUMBER -Н L= NUMBER 	КонтрИзмеритПриборы
Лампа паяльная  NUMBER л	СветотехнИсточнСвета
Гидромотор OMR NUMBER - NUMBER - NUMBER 	З/Ч Гидрооборудован
Болт М NUMBER х NUMBER  ГОСТ NUMBER - NUMBER 	Метизы
Шаблон ЭИ. NUMBER  ТЭСЦ	Инструм. мерительный
Отвод  NUMBER  град ф NUMBER х NUMBER , NUMBER  ст NUMBER 	Металлопрокат
Пробоотборник AOS  NUMBER А	Запчасти
Заслонка дроссельн Т NUMBER . NUMBER . NUMBER . NUMBER СБ ТЭСЦ	З/Ч по чертежам
Резьба  NUMBER мм	Метизы
Лопата совковая	Хоз.товары
Подшипник  NUMBER  М	Запчасти
Вал-шестерня  NUMBER L NUMBER . NUMBER  ТПЦ- NUMBER 	З/Ч по чертежам
Жидкость для мытья полов Прогресс	Канцтовары
Подшипник  NUMBER Н ( NUMBER МВW NUMBER )	Запчасти
Клей карандашный	Канцтовары
Втулка В NUMBER 	З/Ч по чертежам
Труба сантехнич полиэтилен ф NUMBER мм  NUMBER , NUMBER м	Хоз.товары
Набивка сальниковая Donipack  NUMBER   NUMBER x NUMBER 	ИздДляТрубПредохран
Фильтроэлемент ЭФМГ  NUMBER х NUMBER х NUMBER х NUMBER х NUMBER х NUMBER хПС	Запчасти
Уплотнение S NUMBER - NUMBER   NUMBER x NUMBER x NUMBER  Rub NUMBER /Flon NUMBER 	Запчасти
Устройство заряд Anker PowerPort  NUMBER   NUMBER W	Теплоизоляционные
Аммоний фтористый кислый ч	РеактивыХимич.
Натрий кремнефтористый	ХимПродОбщехимНазн
Датчик ВБИ-Щ NUMBER - NUMBER - NUMBER - NUMBER 	Запчасти
Винт  NUMBER х NUMBER  ГОСТ NUMBER - NUMBER (DIN NUMBER )	Метизы
Сверло тв спл по бетону  NUMBER , NUMBER 	Сверла
Блок дверной ДГ	Стройматериалы
Сопло Лехлера  NUMBER . NUMBER . NUMBER . NUMBER . NUMBER . NUMBER 	Запчасти
Вилка перен  NUMBER   NUMBER пол+заз  NUMBER а  NUMBER в IP NUMBER 	Изделия электроустан
Компенсатор КТ NUMBER . NUMBER  оливотто	Запчасти
Цилиндр повор ковша лев  NUMBER - NUMBER 	З/Ч ТракСтроитТехн
Болт М NUMBER х NUMBER  ГОСТ NUMBER - NUMBER 	Метизы
РВД  NUMBER - NUMBER -AOS/AOS- NUMBER x NUMBER / NUMBER x NUMBER - NUMBER 	Запчасти
Болт М NUMBER х NUMBER  ГОСТ NUMBER - NUMBER 	Метизы
Подшипник NUP NUMBER ECP SKF	Подшипники
Плашка М NUMBER х NUMBER , NUMBER 	Инструмент режущий
Ролик HPC- NUMBER  OSBORN	З/Ч по чертежам
Пруток латунный шестигранный  NUMBER  ЛС NUMBER - NUMBER 	МеталлопрокатЦветной
Пневмораспределитель эл  NUMBER - NUMBER -P NUMBER - NUMBER 	З/Ч Пневмооборудов
Образец станд цветность	РеактивыХимич.
Светильник НСП  NUMBER - NUMBER 	ОборудПрочее
Пруток бронзовый ф NUMBER  БрА NUMBER Ж NUMBER Л	Металлопрокат
Уплот К NUMBER -N  NUMBER х NUMBER х NUMBER х NUMBER / NUMBER  Ecopur/Pom	ИздИзПолимерПоЧертеж
Лампа натриев ДНАТ- NUMBER  Е NUMBER 	СветотехнИсточнСвета
"Пиктограмма ""Выход направо"" ПЭУ  NUMBER "	ХозИнвентарь
Клапан  NUMBER DRE  NUMBER  C- NUMBER / NUMBER A NUMBER N NUMBER K NUMBER M	З/Ч Гидрооборудован
Анкета для граждан до  NUMBER  лет.	Насосы
Пластина резьбовая  NUMBER . NUMBER . NUMBER  AS NUMBER 	Сплав твердый
Кабель контрольн гибкий РПШ  NUMBER х NUMBER , NUMBER 	Кабельно-проводников
Пневмоцилиндр ПЦ NUMBER - NUMBER х NUMBER 	Химпродукция
Сверло спиральное ц/х  NUMBER , NUMBER  ВК NUMBER 	Сверла
Ключ торцовый  NUMBER 	Инструменты
Ось тихоходная редуктора ч. NUMBER  Ваdoni	Запчасти
Плашка метрической резьбы М NUMBER 	Инструменты
Лампа ДРИ  NUMBER 	СветотехнИсточнСвета
Подшипник NU  NUMBER  ECP SKF	Подшипники
Фильтроэлемент HY- NUMBER 	Запчасти
Цепь тяговая  NUMBER L NUMBER СБ ТПЦ- NUMBER 	Цепи и звенья
Переключатель управления ПЕ  NUMBER  исп  NUMBER 	Запчасти
Редуктор Ц NUMBER - NUMBER - NUMBER , NUMBER - NUMBER -КЦ-У NUMBER 	Запчасти
Звено С-ПРД- NUMBER , NUMBER - NUMBER 	Цепи и звенья
Ртуть роданистая чда	Химпродукция
Втулка ч.В- NUMBER - NUMBER - NUMBER - NUMBER - NUMBER 	Запчасти
Облучатель Кристалл	Запчасти
Трубка тефлоновая TL NUMBER - NUMBER 	Инструм. абразивный
Элемент фильтр очист топл тракт К NUMBER 	З/Ч ТракСтроитТехн
Крыльчатка вод насоса NUMBER - NUMBER - NUMBER КАМАЗ	З/Ч АвтомобПромышл
Бобышка прямая БП-М NUMBER х NUMBER , NUMBER - NUMBER 	КонтрИзмеритПриборы
Заглушка п/эт ф NUMBER х NUMBER 	ИздДляТрубПредохран
Муфта натяжная К NUMBER  У NUMBER  ф NUMBER мм NUMBER 	Арматура к трубам
Рукав нерж  NUMBER . NUMBER х NUMBER х NUMBER 	МетПродМашиностроен.
Элемент фильтр  NUMBER . NUMBER . NUMBER . NUMBER . NUMBER  DN NUMBER BOLL	Запчасти
Кольцо уплотн короб термост  NUMBER КАМАЗ	З/Ч АвтомобПромышл
Стеллаж ч. NUMBER - NUMBER . NUMBER . NUMBER . NUMBER . NUMBER СБ изм. NUMBER 	Запчасти
Фонарь задний ФП- NUMBER В лев  NUMBER  КАМАЗ	З/Ч АвтомобПромышл
Оргстекло лист  NUMBER мм	ИздИзПолимеровСтанд
Рукав I- NUMBER - NUMBER , NUMBER  ГОСТ  NUMBER - NUMBER 	ИзделияРезино-технич
Фильтр обезз синяя лента ф NUMBER , NUMBER 	РеактивыХимич.
Ролик привода ТНВД  NUMBER . NUMBER  КАМАЗ NUMBER 	З/Ч АвтомобПромышл
Подшипник  NUMBER  CCK/W NUMBER -H NUMBER 	Подшипники
Труба медная ф NUMBER  для кристаллиз	ИнстОснастТехнПоЧерт
Суспензия черн магнитная  NUMBER мл	Химпродукция
М/р МР NUMBER . NUMBER БМ NUMBER -БА NUMBER /БМ NUMBER -БА NUMBER х NUMBER х NUMBER 	Запчасти
Червяк Д NUMBER . NUMBER . NUMBER  ТПЦ- NUMBER 	З/Ч по чертежам
Фланец ХПВХ d NUMBER  Дy NUMBER  Py NUMBER 	АрматураТрубопровод
Втулка бронз В NUMBER  ТПЦ- NUMBER 	З/Ч по чертежам
Ремень приводной Б NUMBER 	Запчасти
Тройник ф NUMBER х NUMBER / NUMBER х NUMBER  исполнение  NUMBER 	Изделия электроустан
Термометр ТКП- NUMBER  Сг  NUMBER + NUMBER / NUMBER , NUMBER   NUMBER  IV	КонтрИзмеритПриборы
Кольцо O-Ring  NUMBER , NUMBER x NUMBER , NUMBER  FPM  NUMBER  Shore A	Запчасти
Хомут  NUMBER   NUMBER / NUMBER ''SC-RK NUMBER   NUMBER -х болт, NUMBER мм алюм	Запчасти
Труба стальная БШГД Ф NUMBER х NUMBER мм ст. NUMBER - NUMBER 	Металлопрокат
Пластина  NUMBER L NUMBER . NUMBER  ТПЦ- NUMBER 	З/Ч по чертежам
Совок пластиковый для мусора	Хоз.товары
Колесо приводное ф NUMBER  ч. NUMBER . NUMBER - NUMBER 	Запчасти
Заглушка полиэтиленовая ф NUMBER х NUMBER 	ИздДляТрубПредохран
Кран шаров  NUMBER Б NUMBER п NUMBER  Ду NUMBER  Ру NUMBER  амер вн/нар	АрматураТрубопровод
Знак дорожн. ограничение по высоте  NUMBER , NUMBER  м	ХозИнвентарь
Ключ электронный Touch Memory с SD- NUMBER A	Инструменты
Мотор-редуктор МЦ NUMBER С- NUMBER - NUMBER - NUMBER , NUMBER - NUMBER -ЦУЗ	Редукторы
Кольцо резин уплотн  NUMBER х NUMBER , NUMBER 	ИзделияРезино-технич
Подшипник GE NUMBER ES	Запчасти
Лампа ДРУФЗ  NUMBER  Е NUMBER 	Комплектующие электр
Грязесъёмник А NUMBER -А  NUMBER х NUMBER х NUMBER х NUMBER , NUMBER  PU	Запчасти
Лебедка рычажная ручная ЛР NUMBER , NUMBER / NUMBER 	КраныТельферыЛебедки
Гидромотор  NUMBER - NUMBER - NUMBER 	З/Ч Гидрооборудован
Сальник коленвала передн двиг ЗМЗ- NUMBER 	З/Ч ТракСтроитТехн
Держатель электрода DE NUMBER   NUMBER А	ИнстОснастТехнПоЧерт
Фильтроэлемент RE  NUMBER G NUMBER  B/ NUMBER 	Фильтры, фильтроэлем
Фторопласт Ф- NUMBER  стержень ф NUMBER мм	ИздИзПолимеровСтанд
РВД  NUMBER - NUMBER -SF NUMBER /SF NUMBER - NUMBER , NUMBER / NUMBER , NUMBER - NUMBER 	ИзделияРезино-технич
Автомат  NUMBER RV NUMBER - NUMBER DA NUMBER   NUMBER , NUMBER - NUMBER , NUMBER А Siemens	Запчасти
Болт М NUMBER х NUMBER   NUMBER . NUMBER  ГОСТ Р NUMBER - NUMBER 	Метизы
Эл двиг W NUMBER   NUMBER P  NUMBER , NUMBER kW B NUMBER T WEG спец	Электродвигатели
Стол  NUMBER х NUMBER х NUMBER  темный орех	ОборудПрочее
Подшипник  NUMBER  CJW NUMBER  ( NUMBER  CC/W NUMBER )	Подшипники
Бетон М  NUMBER  (В  NUMBER )	Стройматериалы
Клапан PВHB-LAN Samhydraulic	З/Ч Гидрооборудован
Метчик М NUMBER х NUMBER , NUMBER 	Инструменты
Кольцо O-Ring  NUMBER , NUMBER x NUMBER , NUMBER  FPM  NUMBER  Shore A	Запчасти
Пластина резьб TI- NUMBER . NUMBER NR NUMBER - NUMBER . NUMBER TRO H NUMBER D NUMBER 	Сплав твердый
Упл K NUMBER - NUMBER   NUMBER x NUMBER x NUMBER ( NUMBER - NUMBER - NUMBER )Pur/Tal	ИздИзПолимерПоЧертеж
Болт трубки дренажной  NUMBER  КАМАЗ	З/Ч АвтомобПромышл
Уплотнение R NUMBER -AF  NUMBER х NUMBER х NUMBER  Ecorubber NUMBER 	ИздИзПолимерПоЧертеж
Пипетка с одной отметкой  NUMBER - NUMBER - NUMBER 	Посуда и приборы хим
Фильтр  NUMBER . NUMBER . NUMBER . NUMBER . NUMBER  DN  NUMBER  № NUMBER / NUMBER 	Запчасти
Мера твердости Роквелла  NUMBER HRC	Инструменты
Уплотнение Roto-Glyd-Ring STG NUMBER Z NUMBER V	Запчасти
Инструмент снятия заусенцев  NUMBER SB USAG	Инструмент слесарный
Преобразователь ультр. Т NUMBER . NUMBER - NUMBER , NUMBER х NUMBER х NUMBER 	Запчасти
Шайба пружинная  NUMBER  ГОСТ NUMBER - NUMBER 	Метизы
ПЭП для УД- NUMBER  П NUMBER - NUMBER , NUMBER - NUMBER - NUMBER , NUMBER -ВМ- NUMBER 	Запчасти
Стакан погружной PN-JBT	Материалы лаб.
Круг  NUMBER  ст NUMBER 	ПрокатСортовойОбНазн
Шайба нерж М NUMBER  DIN NUMBER 	Метизы
Хомут кабельный  NUMBER , NUMBER х NUMBER  нейлон	Изделия электроустан
Распредпункт ПР NUMBER - NUMBER - NUMBER УХЛ NUMBER 	Запчасти
Гидроклапан в корпусе YFIA-XHN-CA/S	Запчасти
Фитинг С NUMBER  Norgren	З/Ч Пневмооборудов
Насос ЦНСГ  NUMBER - NUMBER  с эл дв  NUMBER , NUMBER кВт	Насосы
Манжета ч. NUMBER  поз.№ NUMBER 	Запчасти
Шагомер  NUMBER -GM резьба Премиум AlGa	ОборуТехнологическое
Шайба  NUMBER х NUMBER х NUMBER , NUMBER   NUMBER / NUMBER / NUMBER  КАМАЗ	З/Ч АвтомобПромышл
Модуль торм. NUMBER SL NUMBER - NUMBER HE NUMBER - NUMBER AA NUMBER  Siemens	Запчасти
Индикатор MG NUMBER /IP NUMBER /TROP RED TYPE U	ОборудПрочее
Болт М NUMBER х NUMBER  ГОСТ NUMBER - NUMBER 	Метизы
Кирпич SYNCARBON C F NUMBER T NUMBER  MK NUMBER / NUMBER 	Огнеупоры
Винт  NUMBER х NUMBER   NUMBER . NUMBER .ГОСТ NUMBER - NUMBER (DIN NUMBER )	Метизы
Ключ шестигранный  NUMBER 	Инструмент слесарный
Шкаф металлический для инструмента	Мебель
Эмаль НЦ- NUMBER  синяя ГОСТ  NUMBER - NUMBER 	Прод.Лако-красочная
Протек с мет обеч ф NUMBER   NUMBER - NUMBER  NC  NUMBER  прав	ИздДляТрубПредохран
Маховик  NUMBER - NUMBER  Камаз	З/Ч АвтомобПромышл
Распределитель  NUMBER . NUMBER . NUMBER . NUMBER 	Запчасти
Круг  NUMBER  ст NUMBER Х NUMBER Н NUMBER Т	ПрокатСортовойОбНазн
Датчик весоизмерительный  NUMBER MH NUMBER - NUMBER АD NUMBER 	ДатчСистемАвтоматики
Шкив  NUMBER D NUMBER сб ТПЦ- NUMBER 	З/Ч по чертежам
Плата  NUMBER SE NUMBER - NUMBER AA NUMBER - NUMBER BA NUMBER 	МодулПлатыСистАвтом
Втулка ч.В- NUMBER - NUMBER - NUMBER 	Запчасти
Картридж HP LJ  NUMBER   NUMBER A пурпур cf NUMBER A	ВычОргТехн и З/Ч
Разбавитель VX  NUMBER - NUMBER / NUMBER  LANKWITZER	З/Ч Гидрооборудован
Транзистор Semikron SKM NUMBER GB NUMBER DH NUMBER 	Запчасти
Рукав нерж  NUMBER . NUMBER х NUMBER х NUMBER 	МетПродМашиностроен.
Шуруп  NUMBER х NUMBER  ГОСТ NUMBER - NUMBER 	Метизы
Контроллер температуры E NUMBER CN-R NUMBER MT- NUMBER 	ПриборыСистАвтоматик
Крышка клап в сб левая  NUMBER - NUMBER  КРАЗ	З/Ч ТракСтроитТехн
Муфта ПВД с переходом на мет NUMBER * NUMBER / NUMBER  нар	Хоз.товары
Планка латунная боковая  NUMBER - NUMBER  ТПЦ- NUMBER 	З/Ч по чертежам
Муфта пропиленовая соединительная	Стройматериалы
Пигтейл FPT NUMBER - NUMBER -SC-UPC- NUMBER M	Запчасти
Пластина латунная  NUMBER . NUMBER  ТЭСЦ	З/Ч по чертежам
Шуруп  NUMBER х NUMBER  ГОСТ NUMBER - NUMBER 	Метизы
Подшипник  NUMBER -А FAG/INA	Запчасти
Контактор КТ- NUMBER  кат  NUMBER в	Контакторы
Крышка ч.Н NUMBER . NUMBER . NUMBER . NUMBER 	Запчасти
Клапан DB NUMBER - NUMBER - NUMBER x/ NUMBER  (R NUMBER )	Запчасти
Знак дорожный квадратный	Хоз.товары
Вал-ш.  NUMBER ст. ред.KS NUMBER - NUMBER S кл. NUMBER + ч. NUMBER 	Запчасти
Подпятник  NUMBER   NUMBER  КАМАЗ  NUMBER 	З/Ч АвтомобПромышл
Гайка стремянки  NUMBER  КАМАЗ- NUMBER 	З/Ч АвтомобПромышл
Модуль логическ  NUMBER ED NUMBER - NUMBER MD NUMBER - NUMBER BA NUMBER  LOGO	Блоки систем автомат
Втулка бронз В NUMBER  ТПЦ- NUMBER 	З/Ч по чертежам
Экстрактор кон М NUMBER - NUMBER   NUMBER  USAG	Инструмент режущий
Щебень фракция  NUMBER - NUMBER 	Стройматериалы
ГСО  NUMBER - NUMBER 	Химпродукция
Гайка шлицевая М NUMBER  ГОСТ NUMBER - NUMBER 	Метизы
Трубка электроизоляционная Ф NUMBER Д  NUMBER , NUMBER х NUMBER , NUMBER 	Изделия электроустан
Автомат ВА NUMBER - NUMBER   NUMBER Р  NUMBER а	Запчасти
Лист медный  NUMBER х NUMBER х NUMBER  М NUMBER 	МеталлопрокатЦветной
Фильтр возд  NUMBER - NUMBER - NUMBER  CUMMINS КАМАЗ	З/Ч АвтомобПромышл
Замок зажигания ВАЗ- NUMBER 	З/Ч АвтомобПромышл
Валок  NUMBER - NUMBER . NUMBER 	З/Ч по чертежам
Пипетка градуир  NUMBER - NUMBER - NUMBER - NUMBER   NUMBER 	Материалы лаб.
Канат  NUMBER , NUMBER  ZnB-LHOL-H-P- NUMBER / NUMBER  МС А NUMBER 	Метизы
"Знак ""Внимание.Автомат.включ.оборуд-ия"""	ХозИнвентарь
Удлинитель витой  NUMBER P NUMBER C  NUMBER м	Изделия электроустан
Штуцер ч. NUMBER - NUMBER 	Запчасти
Кабель пневматич. Hydris LC NUMBER   NUMBER м	Запчасти
Рейка В. NUMBER . NUMBER - NUMBER 	З/Ч по чертежам
Кольцо стопорное В NUMBER  ГОСТ NUMBER (DIN NUMBER )	Метизы
Ролик игольчатый  NUMBER х NUMBER , NUMBER 	ИзделияРезино-технич
Круг  NUMBER  СТ NUMBER х NUMBER М	Инструм. абразивный
Стол весовой антивибрационный гранит	Мебель
Направляющая ч. NUMBER - NUMBER . NUMBER 	Запчасти
Манжета армированная  NUMBER х NUMBER х NUMBER  SC  NUMBER N	Запчасти
Контактор Sirius  NUMBER TK NUMBER - NUMBER BB NUMBER  Simens	Контакторы
Масло Shell Spirax MB NUMBER 	Масла фасовочные
Дроссель  NUMBER И NUMBER ДРЛ NUMBER - NUMBER 	Запчасти
Заглушка LM  NUMBER х NUMBER   NUMBER  ДКС	ХимПродОбщехимНазн
Вал  NUMBER - NUMBER . NUMBER  ТПЦ- NUMBER 	З/Ч по чертежам
Канат стальной  NUMBER , NUMBER  ГОСТ  NUMBER - NUMBER 	Метизы
Подшипник  NUMBER  ( NUMBER )	Подшипники
Подшипник  NUMBER  E NUMBER A-M FAG	Запчасти
Подшлемник термостойкий утепл	Хоз.товары
Лента вальцовочная ЭМ- NUMBER   NUMBER х NUMBER 	Запчасти
Манжета маслосъем ф NUMBER  внутр  NUMBER L NUMBER . NUMBER 	ИздИзПолимерПоЧертеж
Кольцо  NUMBER , NUMBER х NUMBER , NUMBER  NBR  NUMBER 	ИздИзПолимеровСтанд
Клей ПВА универсальный	Хоз.товары
Стопор-моноблок  NUMBER -MBS- NUMBER 	Спецогнеупоры
Контакт втычной РГАП. NUMBER . NUMBER - NUMBER 	ЗЧ АвтоматПускКонтак
Уплотнение шевронное М NUMBER х NUMBER - NUMBER 	Запчасти
Блок упр.CPBSA NUMBER A NUMBER A NUMBER C NUMBER : NUMBER  Vacon	Запчасти
Переключатель  NUMBER SB NUMBER - NUMBER AD NUMBER  Siemens	Запчасти
Маркер Memocad  NUMBER , NUMBER  мм  NUMBER  LEG  NUMBER 	Запчасти
Пластина тв спл опорная  NUMBER - NUMBER 	Сплав твердый
Клемма проходная UK  NUMBER . NUMBER  B  NUMBER 	Изделия электроустан
Шестерня БТС  NUMBER . NUMBER . NUMBER  ТПЦ- NUMBER 	З/Ч по чертежам
Ступица  NUMBER  Sennebogen	З/Ч ТракСтроитТехн
Лента ФУМ ТУ NUMBER - NUMBER - NUMBER - NUMBER 	ИздИзПолимеровСтанд
Балка двутавровая  NUMBER Б NUMBER 	Металлопрокат
Панель оператора  NUMBER AV NUMBER - NUMBER BB NUMBER - NUMBER AX NUMBER 	МодулПлатыСистАвтом
Болт ч.В- NUMBER - NUMBER 	Запчасти
Втулка шкворня  NUMBER  КАМАЗ	З/Ч АвтомобПромышл
Подшипник  NUMBER  А	Запчасти
Метчик м/р М NUMBER , NUMBER х NUMBER , NUMBER  компл  NUMBER ед	Инструмент режущий
Электрод сварочный АНО- NUMBER  ф NUMBER 	Метизы
Пластина перовая  NUMBER 	Сверла
Счетчик воды ВКМ- NUMBER 	Запчасти
Подшипник NU  NUMBER  ECJ SKF	Подшипники
Бокорез изол Unior  NUMBER / NUMBER VDEDP art. NUMBER 	Инструменты
Ниппель переходной ХПВХ НР ф NUMBER х NUMBER х NUMBER  Ру NUMBER 	МетПродМашиностроен.
Крышка ч.НР NUMBER . NUMBER . NUMBER . NUMBER 	Запчасти
Пластина ч.Э- NUMBER - NUMBER - NUMBER 	Запчасти
Провод сетевой ПВС  NUMBER х NUMBER , NUMBER 	Кабельно-проводников
Кабель KAWEFLEX NUMBER SK-C-PUR CUL SERVO  NUMBER 	Кабельно-проводников
Колодка тормоз задн  NUMBER - NUMBER ГАЗ NUMBER 	З/Ч АвтомобПромышл
Винт оцинкованный М NUMBER х NUMBER   NUMBER . NUMBER  ГОСТ NUMBER 	Метизы
Аппарат пускорегулир ЭПРА для ЛЛ  NUMBER х NUMBER 	СветотехнИсточнСвета
Командоаппарат КА- NUMBER - NUMBER 	Запчасти
Масло Multi-Lube  NUMBER 	З/Ч Пневмооборудов
Ролик приводной ч. NUMBER - NUMBER 	Запчасти
Синхронизатор  NUMBER - NUMBER  передачи  NUMBER  КАМАЗ	З/Ч АвтомобПромышл
Вкладыш бронз  NUMBER . NUMBER - NUMBER . NUMBER - NUMBER . NUMBER  ТПЦ- NUMBER 	З/Ч по чертежам
Втулка ч.Р NUMBER - NUMBER 	Запчасти
Карабин	Канцтовары
Отвод  NUMBER - NUMBER х NUMBER  ст NUMBER 	Арматура к трубам
Кран пробк муфт  NUMBER Б NUMBER бк Ду NUMBER  Ру NUMBER 	АрматураТрубопровод
Паронит ВА  NUMBER   NUMBER мм	Издел.Асбесто-технич
Фторопласт Ф- NUMBER  стержень ф NUMBER 	ИздИзПолимеровСтанд
Кабель IKB NUMBER / NUMBER . NUMBER  R NUMBER 	Кабельная продукция
Винт  NUMBER х NUMBER  А NUMBER  ГОСТ NUMBER - NUMBER (DIN NUMBER )	Метизы
Подушка роликов ч. NUMBER - NUMBER . NUMBER 	Запчасти
Сепаратор А NUMBER  к комп CompAir	Запчасти
Смесь теплоизоляционная BIOTEX-GM NUMBER 	Материалы вспом-е
Модуль  NUMBER ES NUMBER - NUMBER МD NUMBER 	ПриборыСистАвтоматик
Стакан погружной  NUMBER  импортный	Спецогнеупоры
Клапан  NUMBER - NUMBER . NUMBER  ВТЦ	Запчасти
Блок электр VT NUMBER - NUMBER X арт R NUMBER 	Запчасти
Аминат ДМ- NUMBER 	Химпродукция
Уплотнение SKF SIL NUMBER 	ИздИзПолимерПоЧертеж
Лампа люминесц TL-D- NUMBER W	СветотехнИсточнСвета
Формалин в/с тех.	РеактивыХимич.
Монитор тестовый SC- NUMBER PM Portable Telea	Запчасти
Подушка ч. NUMBER . NUMBER . NUMBER  поз. NUMBER 	Запчасти
Соединитель Siemens  NUMBER ES NUMBER - NUMBER BB NUMBER - NUMBER XA NUMBER 	Запчасти
Сирена сигнальная электрич СС- NUMBER 	Запчасти
Ремень приводной Z(O) NUMBER 	ИзделияРезино-технич
Микрометр МК- NUMBER   NUMBER - NUMBER мм  NUMBER , NUMBER  кл  NUMBER 	Инструменты
Сверло спиральное ц/х  NUMBER , NUMBER 	Сверла
Зажим клиновой US- NUMBER Т модель US NUMBER T  NUMBER , NUMBER 	З/Ч по чертежам
Блок CPV NUMBER -VI-GE-D NUMBER - NUMBER   NUMBER R NUMBER HW NUMBER . NUMBER 	Запчасти
Круг абразивный ПП  NUMBER х NUMBER х NUMBER   NUMBER  СМ  NUMBER С	Инструменты
Резак РПК-М ТУ- NUMBER - NUMBER - NUMBER - NUMBER 	Инструменты
Пластина  NUMBER - NUMBER - NUMBER  ТПЦ- NUMBER 	З/Ч по чертежам
Шланг пневматический арт RHORB NUMBER 	Запчасти
ГСО сталь УГ NUMBER 	Химпродукция
Клапан регул  NUMBER ч NUMBER нж NUMBER  Ду NUMBER  Ру NUMBER  с МИМ	АрматураТрубопровод
Фитинг FI-G- NUMBER S-W NUMBER -MS  NUMBER 	Арматура к трубам
Манжета S NUMBER   NUMBER х NUMBER х NUMBER  Pur/NBR р-р по мет	ИздИзПолимерПоЧертеж
Блок питания стаб  NUMBER EP NUMBER - NUMBER BAOO	Запчасти
Кабель контрольн КГВВ  NUMBER х NUMBER , NUMBER 	Кабельно-проводников
Рельс BM S  NUMBER -N-G NUMBER -KC-R NUMBER - NUMBER - NUMBER - NUMBER -CN	Запчасти
Шайба сферическая прижимная ч.ЭСПЦ- NUMBER 	КонтрИзмеритПриборы
Кольцо R- NUMBER   NUMBER х NUMBER х NUMBER , NUMBER  Ecopur	Запчасти
Лента киперная ЛЭ  NUMBER - NUMBER  х/б	Электроизоляционные
Цилиндр левый ч. NUMBER - NUMBER АСБ	Запчасти
Видеокарта PCI-E GeForce GTX  NUMBER 	ПриборыСистАвтоматик
Реле давления HED  NUMBER  OA NUMBER X/ NUMBER K R NUMBER 	Запчасти
Пробирка П- NUMBER - NUMBER 	Посуда и приборы хим
Винт  NUMBER х NUMBER  ГОСТ NUMBER - NUMBER (DIN  NUMBER )	Метизы
Коробка распр. СП  NUMBER х NUMBER 	Изделия электроустан
Затвор VAG EKN M NUMBER  EPOXID Ду  NUMBER  Py NUMBER 	Запчасти
Светильник станочный НКП  NUMBER - NUMBER - NUMBER 	ОборудПрочее
Эл двиг SK NUMBER L/ NUMBER   NUMBER   NUMBER , NUMBER кВт NORD	Электродвигатели
Полумуфта эл. двигателя ч. NUMBER 	З/Ч ТракСтроитТехн
Заглушка полиэтиленовая  NUMBER х NUMBER мм	ИздДляТрубПредохран
Муфта выключ сцепл в сб  NUMBER - NUMBER  ПАЗ	З/Ч АвтомобПромышл
Извещатель адресный С NUMBER -СТ исп. NUMBER 	ХозИнвентарь
Колесо  NUMBER Д NUMBER . NUMBER  СБ ТПЦ- NUMBER 	З/Ч по чертежам
Наконечник ТМЛ  NUMBER - NUMBER - NUMBER 	Кабельная продукция
Метчик м/р М NUMBER х NUMBER , NUMBER 	Инструмент режущий
Кирпич силикатный М- NUMBER 	Спецогнеупоры
Сверло спиральное ц/х  NUMBER , NUMBER 	Сверла
Пневмошлифмашинка BS NUMBER - NUMBER H- NUMBER 	Инструменты
Кольцо ч.  NUMBER - NUMBER / NUMBER 	Запчасти
Кисть малярная плоская В  NUMBER 	Инструменты
Пневмораспределитель В NUMBER - NUMBER А- NUMBER 	З/Ч Пневмооборудов
Пневмораспределитель эл  NUMBER - NUMBER -Р NUMBER - NUMBER 	З/Ч Пневмооборудов
Сверло спиральное Ц/Х  NUMBER , NUMBER  удл	Сверла
Заглушка полиэтиленовая ф NUMBER х NUMBER 	ИздДляТрубПредохран
Подшипник  NUMBER  СС/W NUMBER 	Подшипники
Пуансон ч. NUMBER - NUMBER - NUMBER - NUMBER - NUMBER 	Инструменты
Прибор контр ф резьб труб П-Д  NUMBER - NUMBER 	Инструм. мерительный
Гайка М NUMBER х NUMBER , NUMBER   NUMBER -П ГАЗ  NUMBER 	З/Ч АвтомобПромышл
Аккумулятор BP-LC NUMBER / NUMBER - NUMBER PI	Запчасти
Ролик НК NUMBER . NUMBER  ТПЦ- NUMBER 	З/Ч по чертежам
Кольцо R NUMBER   NUMBER x NUMBER x NUMBER , NUMBER  NBR	Запчасти
Вентиль  NUMBER / NUMBER  BAV- NUMBER - NUMBER -IIN-NNEN NUMBER 	Запчасти
Отвод  NUMBER - NUMBER х NUMBER 	Арматура к трубам
Картридж  NUMBER . NUMBER  СА NUMBER - NUMBER F Donaldson	Расходные материалы
Манжета ч. NUMBER . NUMBER . NUMBER  СБ	Запчасти
Пыльник рулевой  NUMBER - NUMBER  КАМАЗ	З/Ч АвтомобПромышл
Круг  NUMBER  ст NUMBER Х NUMBER Н NUMBER 	ПрокатСортовойОбНазн
Вкладыш верхний  NUMBER   NUMBER СБ	ИздИзПолимерПоЧертеж
Зажим для труб DIN NUMBER  SPAL  NUMBER . NUMBER  AL	Метизы
"Знак ""Осторожно.Возможно травмир-ие рук"""	ХозИнвентарь
Разъем Tyco Electronics  NUMBER - NUMBER - NUMBER 	Запчасти
Эл.двигатель АИР  NUMBER S NUMBER   NUMBER кВт  NUMBER М NUMBER 	Запчасти
Подшипник  NUMBER ZZ	Подшипники
Подшипник  NUMBER  ( NUMBER )	Подшипники
Оправка водоохлаждаемая ч.Э- NUMBER - NUMBER - NUMBER 	Инструменты
Клапан DBDS NUMBER G NUMBER X/ NUMBER  R NUMBER 	Запчасти
Редуктор цилиндрич PHA NUMBER P NUMBER - NUMBER  Sumitomo	Редукторы
Винт попереч подачи с гайкой к ст  NUMBER М NUMBER 	З/Ч кМеталлообОборуд
Лента виниловая изоляционная  NUMBER  Т	Электроизоляционные
Сольвент ГОСТ  NUMBER - NUMBER 	Химпродукция
Заглушка полиэтиленовая ф NUMBER х NUMBER 	ИздДляТрубПредохран
Болт М NUMBER х NUMBER  ГОСТ NUMBER - NUMBER 	Метизы
Балка № NUMBER  ч.Э- NUMBER - NUMBER  вариант  NUMBER 	Запчасти
Метчик трубный конический Rc  NUMBER 	Инструмент режущий
Пол наливной самовыравнивающийся  NUMBER кг	ХимПродОбщехимНазн
Подшипник  NUMBER - NUMBER А	Запчасти
Устройство проверки указателей УПУН-М	З/Ч АвтомобПромышл
Манжета ч.Р- NUMBER 	Запчасти
Болт М NUMBER х NUMBER  ГОСТ NUMBER - NUMBER 	Метизы
Кольцо R NUMBER   NUMBER х NUMBER , NUMBER  Ecorubber- NUMBER 	Запчасти
Металлорукав Герда-МГ- NUMBER -нг-HF-М	МатерСтроительные
Держатель зажима матр  NUMBER - NUMBER - NUMBER  ТПЦ- NUMBER 	ИнстОснастТехнПоЧерт
Ремень приводной Z(O) NUMBER 	ИзделияРезино-технич
Плашка М NUMBER х NUMBER , NUMBER 	Инструмент режущий
Редуктор с эл.двиг ADE  NUMBER TD DEL Demag	Редукторы
Валок ф NUMBER   NUMBER ФВ ч.В- NUMBER - NUMBER 	Инструменты
Отвод  NUMBER  град ф NUMBER х NUMBER , NUMBER  ст NUMBER 	Металлопрокат
Заглушка п/эт ф NUMBER х NUMBER 	ИздДляТрубПредохран
Ремкомплект  NUMBER F NUMBER  Graco  NUMBER ед	З/Ч к компрессорам
Бур к перфоратору SDS MAX  NUMBER х NUMBER х NUMBER 	Сверла
Смазка Berutox M  NUMBER   ЕРК  NUMBER 	Смазки
Манжета на трубу ф NUMBER  ТПЦ- NUMBER  в сборе	ИздИзПолимерПоЧертеж
Комплект уплотнений г/ц Б NUMBER - NUMBER - NUMBER ВО	Запчасти
Реле РСВ NUMBER - NUMBER  ~ NUMBER В  NUMBER - NUMBER сек. винт	Запчасти
Модуль мембранный DESAL AG NUMBER F  NUMBER 	Запчасти
Светильник НПБ NUMBER 	ОборудПрочее
Резец проходной прямой  NUMBER х NUMBER  ВК NUMBER 	Резцы
Вилка ССИ- NUMBER  ИЭК	Запчасти
"Клеймо тв спл  NUMBER ""Л"" ВК NUMBER "	Инструменты
Мера твердости по Виккерсу  NUMBER HV NUMBER 	Инструменты
Метчик м/р М NUMBER х NUMBER , NUMBER  компл  NUMBER ед	Инструмент режущий
Рукав HD NUMBER -PА NUMBER SF NUMBER -PA NUMBER SF NUMBER . NUMBER - NUMBER 	ИзделияРезино-технич
Кабель КПСВЭВнг-А-LS  NUMBER х NUMBER х NUMBER , NUMBER 	Кабельная продукция
Эл двиг МТКН- NUMBER - NUMBER   NUMBER квт  NUMBER  о/м  NUMBER 	Электродвигатели
Развертка  NUMBER , NUMBER  Н NUMBER 	Инструмент режущий
Рычаг мешалки левый арт. NUMBER . NUMBER . NUMBER 	Запчасти
М/р МР NUMBER . NUMBER БМ NUMBER -БА NUMBER /БМ NUMBER -БА NUMBER х NUMBER х NUMBER 	Запчасти
Масло Mobilgear  NUMBER  XP  NUMBER 	Масла фасовочные
Бокорезы диэлектрическими ручками  NUMBER мм	Инструменты
Датчик ВБО-Э NUMBER - NUMBER Р- NUMBER -С	Запчасти
Гайка шестигранная М NUMBER   NUMBER . NUMBER  ГОСТ NUMBER 	Метизы
Паста КПТ- NUMBER  теплопроводная  NUMBER г	З/Ч ТракСтроитТехн
Рукав РВД  NUMBER - NUMBER  (М NUMBER х NUMBER , NUMBER ) NUMBER мм	ИзделияРезино-технич
Насос дренажн  NUMBER Гном  NUMBER - NUMBER   NUMBER м/з/ч Н= NUMBER м	Насосы
Гидроаккумулятор АМS NUMBER . NUMBER P NUMBER CG NUMBER   NUMBER . NUMBER л	Запчасти
Фонарь аккум светод налоб с блоком питан	ОборудБытовое
Сверло спиральное к/х  NUMBER , NUMBER 	Сверла
Упор уплотнения ч.Э- NUMBER - NUMBER 	Запчасти
Гильза кристаллизатора O NUMBER  R NUMBER 	КонтрИзмеритПриборы
Полурессора ТОНАР  NUMBER  BPW	КонтрИзмеритПриборы
Кабель с раз.  NUMBER - NUMBER - NUMBER - NUMBER  Murr	Кабельная продукция
Преобразователь  NUMBER SE NUMBER - NUMBER AD NUMBER - NUMBER CA NUMBER 	Запчасти
Точка тестовая SMK- NUMBER - NUMBER S-B-K-GS-W NUMBER 	Запчасти
Подшипник  NUMBER - NUMBER АС NUMBER 	Запчасти
Ось блоков ч.М- NUMBER - NUMBER 	Запчасти
Светильник ГО NUMBER - NUMBER - NUMBER  Мега б/ПРА GALAD	СветотехнИсточнСвета
Сольвент нефтяной	ХозИнвентарь
Аппарат окрасочный Merkur  NUMBER : NUMBER Арт G NUMBER C NUMBER 	ИздИзПолимеровСтанд
@Распределитель  NUMBER WE NUMBER x/EG NUMBER N NUMBER K NUMBER 	Запчасти
Ремкомплект упл кол  NUMBER цил компр КАМАЗ  NUMBER ед	З/Ч АвтомобПромышл
Угол лотка горизонт  NUMBER град  NUMBER х NUMBER 	Изделия электроустан
Полотенце махровое	ХозИнвентарь
Стакан погружной PN-JBT-K	Материалы лаб.
Кабель KAWEFLEX SK-C-PUR UL/CSA SERV  NUMBER G NUMBER 	Кабельно-проводников
Проволока наплавочная DN-S  NUMBER , NUMBER 	Метизы
Втулка шестер  NUMBER  пер КПП  NUMBER . NUMBER  КАМАЗ	З/Ч АвтомобПромышл
Гайка М NUMBER  ГОСТ NUMBER - NUMBER 	Метизы
Электрододержатель Standart  NUMBER A	КонтрИзмеритПриборы
Муфта выключения сцеплен  NUMBER - NUMBER с NUMBER А ДТ  NUMBER 	Запчасти
Образец стандартный МВН- NUMBER Х С NUMBER 	Химпродукция
Крышка концевая D-URTK Ph NUMBER 	Изделия электроустан
Контактор Sirius  NUMBER TK NUMBER - NUMBER CB NUMBER  Simens	Контакторы
Сверло спиральное ц/х  NUMBER , NUMBER 	Сверла
Фильтроэлемент RE  NUMBER G NUMBER B/ NUMBER 	Фильтры, фильтроэлем
Фланец  NUMBER - NUMBER - NUMBER 	АрматураТрубопровод
Светильник ОБН NUMBER - NUMBER - NUMBER 	СветотехнИсточнСвета
Ниппель з/т ТМК UP PF ф NUMBER , NUMBER 	ИздДляТрубПредохран
Сверло спиральное ц/х  NUMBER , NUMBER 	Сверла
Затвор L NUMBER XN NUMBER  DN NUMBER  PN NUMBER  Camozzi	Запчасти
Вал  NUMBER L NUMBER . NUMBER 	З/Ч по чертежам
Муфта переходная PPR  NUMBER х NUMBER 	ИздИзПолимеровСтанд
Кольцо  NUMBER х NUMBER , NUMBER  NBR  NUMBER 	ИздИзПолимеровСтанд
Гайка М NUMBER  ГОСТ NUMBER - NUMBER 	Метизы
Задвижка  NUMBER с NUMBER нж Ду  NUMBER  ТУ NUMBER - NUMBER - NUMBER - NUMBER 	Запчасти
Блок резисторов Б NUMBER У NUMBER  ИРАК. NUMBER . NUMBER . NUMBER - NUMBER 	Запчасти
Патрубок средний  NUMBER  КАМАЗ	З/Ч АвтомобПромышл
Цилиндр сцепления главн  NUMBER  ГАЗ	З/Ч АвтомобПромышл
Автомат T NUMBER N NUMBER  M-LRI  NUMBER А  NUMBER SDA NUMBER R NUMBER 	ВыключатАвтоматич
Лампа OSRAM DULUX L  NUMBER W/ NUMBER   NUMBER G NUMBER 	Комплектующие электр
Плашка М NUMBER х NUMBER , NUMBER 	Инструмент режущий
Вал-шестерня  NUMBER . NUMBER . NUMBER . NUMBER  КЦ	З/Ч по чертежам
Винт М NUMBER х NUMBER  ГОСТ  NUMBER - NUMBER 	Метизы
Фильтр тонкой очистки  NUMBER - NUMBER ГАЗель	З/Ч АвтомобПромышл
'Монитор  NUMBER '' ЖК ViewSonic	ВычОргТехн и З/Ч
Средство моющее щелочное Унивеко  NUMBER л	Химпродукция
Соединение переходное RSDKO  NUMBER / NUMBER 	Запчасти
Строп текст петл СТП- NUMBER , NUMBER / NUMBER 	Стропы
Стаканчик (бюкс) СН- NUMBER / NUMBER  ТС	Посуда и приборы хим
Кирпич периклазоуглерод ПУ- NUMBER   NUMBER / NUMBER 	Периклазоуглеродисты
Одеяло FiberBlanket ZA  NUMBER   NUMBER кг/м NUMBER 	Теплоизоляционные
Рукав м. NUMBER Х NUMBER Н NUMBER Т МР NUMBER . NUMBER  Ш NUMBER   NUMBER х NUMBER х NUMBER 	Запчасти
Соединение приварное прямое ER  NUMBER / NUMBER -S	Запчасти
Клапан  NUMBER WE NUMBER  E NUMBER X/EG NUMBER N NUMBER K NUMBER /V	Запчасти
Пластина FI-GP- NUMBER L-W NUMBER A-T NUMBER N NUMBER /N NUMBER 	Инструмент слесарный
Накладка эскиз  NUMBER . NUMBER . NUMBER  СБ ТПЦ- NUMBER 	З/Ч по чертежам
Заплатка камерная Rossvik  NUMBER - NUMBER ( NUMBER х NUMBER мм)	З/Ч АвтомобПромышл
Индикатор световой  NUMBER SB NUMBER - NUMBER AA NUMBER 	КнопкиПостыУправлен
Стартер люминисцентной лампы СК- NUMBER 	Запчасти
Термодат- NUMBER М NUMBER / NUMBER Р/ NUMBER / NUMBER М-РВ/ NUMBER УВ/ NUMBER Р/ NUMBER Р	ПриборыСистАвтоматик
Винт М NUMBER х NUMBER   NUMBER , NUMBER  ГОСТ NUMBER , DIN NUMBER 	Метизы
Сверло спиральное к/х  NUMBER , NUMBER 	Сверла
Комплект унив.TENRAD для радиаторов  NUMBER / NUMBER 	Запчасти
Кулачок К- NUMBER   NUMBER - NUMBER . NUMBER  ТПЦ- NUMBER 	ИнстОснастТехнПоЧерт
Муфта переходная PPR  NUMBER х NUMBER 	ИздИзПолимеровСтанд
Подшипник  NUMBER  ( NUMBER   NUMBER RS)	Подшипники
"Клеймо тв спл  NUMBER "" NUMBER "" ВК NUMBER "	Инструменты
Затвор дисковый Ду NUMBER  Ру NUMBER  с КОФ	АрматураТрубопровод
Разъем DOS  NUMBER -G  NUMBER  Sick	Изделия электроустан
Фреза сборная MT NUMBER -B NUMBER R NUMBER SD NUMBER 	Фрезы
Уплотнение подшипника SKF TSN NUMBER S	Запчасти
Шланг измерительный SMS- NUMBER - NUMBER -A-C NUMBER F	Запчасти
Плашка коническая трубная R  NUMBER / NUMBER 	Инструмент режущий
Перегородка PR NUMBER - NUMBER   NUMBER SDA NUMBER R NUMBER 	Арматура к трубам
Затвор дисковый Ду NUMBER  Ру NUMBER 	АрматураТрубопровод
Резец отрезной  NUMBER х NUMBER  Т NUMBER К NUMBER 	Резцы
Модуль  NUMBER GK NUMBER - NUMBER CX NUMBER - NUMBER XE NUMBER 	Запчасти
Клапан  NUMBER L NUMBER А ТПЦ- NUMBER 	З/Ч по чертежам
Рым-гайка М NUMBER  DIN  NUMBER 	Метизы
Фильтр патрон осушителя возд ПАЗ- NUMBER - NUMBER 	З/Ч ТракСтроитТехн
Башмак деф ЭК NUMBER . NUMBER . NUMBER . NUMBER . NUMBER Д- NUMBER  ТПЦ- NUMBER 	ИздИзПолимерПоЧертеж
Лента для определения запыленности  NUMBER мм	Резцы
Уплотнение S NUMBER -P  NUMBER x NUMBER x NUMBER , NUMBER  Ecopur	Запчасти
Лампа автомоб  NUMBER V  NUMBER , NUMBER W	СветотехнИсточнСвета
Полумуфта  NUMBER - NUMBER  ТПЦ- NUMBER 	З/Ч по чертежам
Метчик трубный цилиндр G  NUMBER / NUMBER 	Инструмент режущий
Подшипник  NUMBER  E NUMBER A-M FAG	Запчасти
Лампа кварцево-галогенная КГ  NUMBER 	Комплектующие электр
Хомут для СИП ХС- NUMBER 	ПриборыСистАвтоматик
Винт М NUMBER х NUMBER   NUMBER . NUMBER  ГОСТ NUMBER , DIN  NUMBER 	Метизы
Манжета армиров  NUMBER х NUMBER х NUMBER , NUMBER  ГОСТ  NUMBER - NUMBER 	ИзделияРезино-технич
Резьба ф NUMBER  сталь NUMBER 	Метизы
Датчик ВБИ-Ф NUMBER - NUMBER С- NUMBER -З	Запчасти
Кабель QLFLEХ NSHTQU-О  NUMBER х NUMBER  ар  NUMBER 	Кабельно-проводников
Набивка ЛП- NUMBER   NUMBER мм	ИздДляТрубПредохран
Провод установ ПВ- NUMBER   NUMBER х NUMBER 	Кабельно-проводников
Пластина резьб TI- NUMBER . NUMBER ER NUMBER - NUMBER . NUMBER TRO H NUMBER D NUMBER 	Сплав твердый
Строп стал канат  NUMBER СК- NUMBER , NUMBER / NUMBER 	Стропы
Подшипник  NUMBER EK+Н NUMBER 	Подшипники
Лак КО- NUMBER к	Стройматериалы
Кольцо R- NUMBER   NUMBER х NUMBER х NUMBER  NBR	ИздИзПолимеровСтанд
Рычаг  NUMBER L NUMBER . NUMBER СБ ТПЦ- NUMBER 	З/Ч по чертежам
Пластина тв спл TNMM  NUMBER  PT NUMBER 	Сплав твердый
Вал-шестерня ч.Р- NUMBER 	Запчасти
Вал-шестерня  NUMBER L NUMBER . NUMBER А ТПЦ- NUMBER 	З/Ч по чертежам
Кисть макловица  NUMBER х NUMBER  ГОСТ NUMBER - NUMBER 	Инструменты
Винт  NUMBER х NUMBER  ГОСТ NUMBER - NUMBER (DIN NUMBER )	Метизы
Резак SB  NUMBER F- NUMBER 	ИнстОснастТехнПоЧерт
Кольцо Х-Ring  NUMBER х NUMBER , NUMBER  NBR NUMBER 	ИздИзПолимерПоЧертеж
Датчик RHV NUMBER MP NUMBER AS NUMBER G NUMBER  MTS	ДатчСистемАвтоматики
Подшипник  NUMBER  (NU NUMBER )	Подшипники
Винт US  NUMBER -T NUMBER P	Резцы
Выключатель ВА NUMBER - NUMBER - NUMBER - NUMBER А УХЛ NUMBER 	Запчасти
Сталь круглая ф NUMBER  ст  NUMBER  сп/пс	Металлопрокат
Соединение прям быстроразъем KQ NUMBER H NUMBER - NUMBER S	З/Ч Гидрооборудован
Кран шаровов Ду NUMBER 	Запчасти
Кольцо разрезное Н NUMBER - NUMBER Ж- NUMBER  к компр  NUMBER М NUMBER 	З/Ч к НасосВентилят
Подшипник  NUMBER M (N  NUMBER MB)	Запчасти
Уплотнение вала радиальное  NUMBER  Linsiger	Запчасти
Бур к перфоратору SDS MAX  NUMBER х NUMBER / NUMBER 	Сверла
Винт  NUMBER х NUMBER  ГОСТ NUMBER - NUMBER (DIN  NUMBER )	Метизы
Вал-шестерня ч.Р- NUMBER - NUMBER 	Запчасти
Нож ч. NUMBER - NUMBER 	Инструменты
Лента сигнальная бело-красная	Запчасти
Знак дорожный  NUMBER . NUMBER   NUMBER  типоразмер	ХозИнвентарь
Ключ гаечный КГД  NUMBER х NUMBER 	Инструмент слесарный
Коробка клеммная  NUMBER х NUMBER х NUMBER 	Изделия электроустан
РВД  NUMBER - NUMBER -AOS/AOS-M NUMBER x NUMBER /M NUMBER x NUMBER - NUMBER 	Запчасти
Кувалда  NUMBER кг с фиберглассовой ручкой	Инструмент слесарный
Винт  NUMBER х NUMBER  ГОСТ NUMBER - NUMBER (DIN  NUMBER )	Метизы
Резец резьбовой наружный  NUMBER х NUMBER  Т NUMBER К NUMBER 	Резцы
Корпус модульный пластик навес ЩРН-П- NUMBER 	Изделия электроустан
Раствор калибровочный Hanna HI  NUMBER L	ХимПродОбщехимНазн
Кулачек патрона нижний ч. NUMBER - NUMBER 	Резцы
Кнопка  NUMBER з ч LAY NUMBER -BA NUMBER  BBT NUMBER -BA-K NUMBER 	КнопкиПостыУправлен
Фитинг С NUMBER 	З/Ч Пневмооборудов
Рукав пожарный ф NUMBER мм  NUMBER м с ГР- NUMBER   NUMBER МПа	ОборПожарныйИнвен
Втулка бронз В NUMBER  ТПЦ- NUMBER 	З/Ч по чертежам
Картридж HP OfficeJet  NUMBER  CD NUMBER AE черн	ВычОргТехн и З/Ч
Телефон Panasonic KX-TS  NUMBER  RU	ПриборыСистАвтоматик
Круг  NUMBER  ст NUMBER Х NUMBER Н NUMBER МФ	ПрокатСортовойОбНазн
Стопор А NUMBER - NUMBER . NUMBER . NUMBER 	Резцы
Разъединитель  NUMBER NP NUMBER - NUMBER CA NUMBER  Siemens	Запчасти
Круг  NUMBER  ст NUMBER ХМА	ПрокатСортовойОбНазн
Строп стал канат УСК NUMBER - NUMBER , NUMBER / NUMBER 	Стропы
Коврик фильтровальный  NUMBER х NUMBER мм FA NUMBER L	Запчасти
Корпус подш пер в сб  NUMBER - NUMBER  КАМАЗ	З/Ч АвтомобПромышл
Клапан обратн фланц  NUMBER ч NUMBER бр Ду NUMBER  Ру NUMBER 	АрматураТрубопровод
Ключ накидной ударный КГКУ  NUMBER 	Инструмент слесарный
Подшипник  NUMBER Н ( NUMBER W NUMBER )	Запчасти
Пластина C NUMBER  Ceratizit	Сплав твердый
Фитинг FI-W- NUMBER S-W NUMBER -MS  NUMBER 	Арматура к трубам
Кабель PROFINET FC C-PVC UL/CSA  NUMBER X NUMBER XAWG	Кабельно-проводников
Конденсатор К NUMBER - NUMBER   NUMBER в  NUMBER мкф	Конденсаторы
"Клеймо тв спл  NUMBER ""Б"" ВК NUMBER "	Инструменты
Тормоз ТКГ- NUMBER 	З/Ч ГрузПодъемОборуд
Пресс штамповочный NADSM  NUMBER / NUMBER B (б/у)	Запчасти
Пластина керамичес SNUN  NUMBER  ВОК NUMBER 	Сплав твердый
Набор ключей шестигранных  NUMBER  Gedore	Инструмент слесарный
Соединение повор. NUMBER -BEEC-L NUMBER -G NUMBER / NUMBER B VOSS	Запчасти
Прокладка ч.Н NUMBER . NUMBER . NUMBER . NUMBER - NUMBER 	Запчасти
Подшипник М NUMBER -М NUMBER CD-HTCS	Запчасти
Винт  NUMBER х NUMBER  ГОСТ NUMBER - NUMBER  DIN NUMBER 	Метизы
Отвод  NUMBER град  NUMBER х NUMBER  ст NUMBER 	Металлопрокат
Пластина опорная  NUMBER - NUMBER 	Сплав твердый
Пакет пружин ч. NUMBER 	Запчасти
Подшипник  NUMBER - NUMBER Z	Запчасти
Манометр кислородный МП NUMBER -Уф  NUMBER - NUMBER кгс/см NUMBER 	КонтрИзмеритПриборы
Элемент питания CR NUMBER A  NUMBER V	АккумБатареи и Элем
Гидрораспр. РЕ  NUMBER . NUMBER - NUMBER  Г NUMBER 	Запчасти
Контур охл панели F РЗ. NUMBER . NUMBER . NUMBER . NUMBER 	ТехнологОборудЧертеж
Клапан LC  NUMBER  DB NUMBER  E  NUMBER X/V REXROTH	Запчасти
Уайт-спирит	Химпродукция
Втулка бронз В NUMBER  ТПЦ- NUMBER 	З/Ч по чертежам
Пневмораспределитель  NUMBER - NUMBER - NUMBER  Camozzi	З/Ч Пневмооборудов
Стакан-дозатор КУСД - NUMBER М	Спецогнеупоры
Корпус подшипника FAG SNV NUMBER -F-L+DH NUMBER 	Запчасти
Втулка ф NUMBER х NUMBER х NUMBER  Adipren L- NUMBER 	Запчасти
Фитинг  NUMBER С NUMBER - NUMBER - NUMBER 	Запчасти
Инструмент изм величин подреза ЭИ  NUMBER . NUMBER 	Резцы
Устройство испыт для слож защит Нептун- NUMBER 	З/Ч Гидрооборудован
Провод обмот ПСДК  NUMBER х NUMBER 	Кабельно-проводников
Тепловизор Flir E NUMBER 	Расходные материалы
Пускатель ПМ ГОСТО  NUMBER - NUMBER - NUMBER   NUMBER В	Запчасти
Ключ отворота задв искроб  NUMBER x NUMBER   NUMBER 	Инструмент слесарный
Блок гнездовой PN-SML- NUMBER  Puyang	Спецогнеупоры
Штамп высадочный ч. NUMBER - NUMBER - NUMBER - NUMBER 	Инструменты
Аллонж ИРА- NUMBER - NUMBER  открытый пластм с сеткой	КонтрИзмеритПриборы
Краска водоэмульсионная ВД-АК	Химпродукция
@Соединение резьбовое DS-VDDKO  NUMBER -S/SO NUMBER 	Запчасти
Балка № NUMBER  ч.Э- NUMBER - NUMBER  вариант  NUMBER 	Запчасти
Рукав PYROJACKET PJ- NUMBER 	Запчасти
Болт м NUMBER х NUMBER   NUMBER . NUMBER  ГОСТ  NUMBER 	Метизы
Автомат ВА NUMBER - NUMBER   NUMBER Р  NUMBER а	Запчасти
Болт М NUMBER х NUMBER  ГОСТ NUMBER - NUMBER 	Метизы
Кожух нижний левый ч.В- NUMBER - NUMBER 	Запчасти
Болт М NUMBER х NUMBER  ГОСТ NUMBER - NUMBER 	Метизы
Опора ч.Э- NUMBER - NUMBER 	Запчасти
Ключ гаечный кольцевой коленч КГН  NUMBER х NUMBER 	Инструмент слесарный
Вал кардан. прав.машина ч.Р- NUMBER  L= NUMBER мм	Запчасти
Втулка бронз В NUMBER  ТПЦ- NUMBER 	З/Ч по чертежам
Манжета ч.Р- NUMBER 	Запчасти
Фреза отрезная  NUMBER х NUMBER , NUMBER 	Фрезы
ГСО алюминий-ион  NUMBER , NUMBER  мг/см NUMBER   NUMBER - NUMBER 	Химпродукция
Заглушка полиэтиленовая ф NUMBER х NUMBER 	ИздДляТрубПредохран
Шестерня распр  NUMBER - NUMBER  дв УМЗ  NUMBER 	З/Ч АвтомобПромышл
Линейка поверочная ШД- NUMBER мм	Инструм. мерительный
Клапан обратный RD NW  NUMBER  HS Hansa-Flex	Запчасти
Вставка зажимная  NUMBER L NUMBER Е ТПЦ- NUMBER 	З/Ч по чертежам
Втулка В NUMBER 	З/Ч по чертежам
Ламинатор Leitz iLam Touch  NUMBER  A NUMBER   NUMBER мкм	ИздИзПолимеровСтанд
Подшипник SKF  NUMBER .М	Подшипники
Датчик темпКТХК NUMBER . NUMBER - NUMBER -к NUMBER -И-С NUMBER - NUMBER - NUMBER 	ДатчСистемАвтоматики
Воздухоотводчик нерж КАТ NUMBER  Ду NUMBER  Ру NUMBER 	АрматураТрубопровод
Гайка накидная Lechler NUMBER . NUMBER . NUMBER . NUMBER . NUMBER . NUMBER 	Запчасти
Пневмогидроусилитель  NUMBER  КАМАЗ	З/Ч АвтомобПромышл
Винт М NUMBER х NUMBER   NUMBER . NUMBER  ГОСТ NUMBER , DIN NUMBER 	Метизы
Сопло подогревающее ALFA № NUMBER 	Запчасти
ТпшВГП ГОСТ NUMBER   NUMBER пс  NUMBER   NUMBER , NUMBER 	Трубы
Ремень приводной Z(O) NUMBER 	ИзделияРезино-технич
Электрошкафчик EB № NUMBER . NUMBER 	Запчасти
Фартук х/б	СИЗ (без размеров)
Лоток лестничный ДКС  NUMBER х NUMBER х NUMBER 	Изделия электроустан
Муфта ЛИР  NUMBER - NUMBER - NUMBER 	ДатчСистемАвтоматики
Паста монтажная Rossvik	З/Ч АвтомобПромышл
Вилка  NUMBER L NUMBER . NUMBER . NUMBER В- NUMBER  ТПЦ- NUMBER 	З/Ч по чертежам
Кислота сульфосалициловая	Химпродукция
Уплотнение ч. NUMBER  - NUMBER . NUMBER  DIN A NUMBER 	Запчасти
Отвертка плоская  NUMBER х NUMBER , NUMBER х NUMBER , NUMBER 	Инструменты
Модуль SKM NUMBER GAL NUMBER D корп.SEMITRANS NUMBER  Sem	Запчасти
Стекло листовое М NUMBER  толщ  NUMBER мм	МатерСтроительные
Тройник полипропиленовый ф NUMBER 	ИздИзПолимеровСтанд
Углошлифмашина W NUMBER   NUMBER Вт  NUMBER мм	ОборудПрочее
Реле  NUMBER TX NUMBER - NUMBER FB NUMBER 	Запчасти
Колесо зубчатое  NUMBER L NUMBER . NUMBER А ТПЦ- NUMBER 	З/Ч по чертежам
Седло клапана ч.Р- NUMBER - NUMBER 	Запчасти
Диск тормозной ч.Р- NUMBER 	Запчасти
Полумуфта ч. NUMBER А	Запчасти
Автомат ВА NUMBER - NUMBER   NUMBER Р  NUMBER а	Запчасти
Бинт Мартенса	МетПродМашиностроен.
Фильтр мебранный  NUMBER , NUMBER  мкм НЦ d NUMBER мм	КонтрИзмеритПриборы
Подшипник  NUMBER  CC/W NUMBER 	Подшипники
Лампа  NUMBER v- NUMBER w W NUMBER . NUMBER * NUMBER , NUMBER d габаритов	Комплектующие электр
Подшипник  NUMBER  (NU NUMBER )	Подшипники
Гайка накидная М NUMBER LCFX	Запчасти
Отвертка с накладными щечками  NUMBER х NUMBER , NUMBER 	Инструмент слесарный
Блок контактный  NUMBER З для LAY NUMBER  зеленый	ЗЧ АвтоматПускКонтак
Фланец  NUMBER - NUMBER - NUMBER  ГОСТ  NUMBER 	АрматураТрубопровод
Клемма эл комп ASK  NUMBER /ENLD NUMBER D  NUMBER VAC	З/Ч к компрессорам
Прокладка  NUMBER - NUMBER - NUMBER - NUMBER  к компр  NUMBER М NUMBER   NUMBER / NUMBER 	З/Ч к компрессорам
Пучок проводов задних фонар  NUMBER  КАМАЗ	З/Ч АвтомобПромышл
Мера установочная FSTD-BCSG- NUMBER B- NUMBER -B	ОборудПрочее
Кнопка управления КМУ NUMBER  IEK	КнопкиПостыУправлен
Клапан H- NUMBER WEH NUMBER D NUMBER X/OF NUMBER EG NUMBER N NUMBER EK NUMBER 	Запчасти
Фланец А NUMBER . NUMBER . NUMBER  ЭСПЦ	З/Ч по чертежам
Провод СИП- NUMBER   NUMBER х NUMBER + NUMBER х NUMBER 	Кабельно-проводников
Блок цилиндров  NUMBER - NUMBER - NUMBER  КАМАЗ	З/Ч АвтомобПромышл
Втулка рессорная  NUMBER - NUMBER  Волга	З/Ч АвтомобПромышл
Концентрат КШУ- NUMBER П	ХимПродОбщехимНазн
Канат стальной  NUMBER , NUMBER  ГОСТ  NUMBER - NUMBER 	Метизы
Видеокамера КРС NUMBER ВН/ NUMBER 	ОборуТехнологическое
Шпонка ч.НР NUMBER . NUMBER . NUMBER . NUMBER 	Запчасти
Задвижка фланц  NUMBER ч NUMBER бр Ду NUMBER  Ру NUMBER 	АрматураТрубопровод
Втулка ч.Э- NUMBER . NUMBER . NUMBER - NUMBER / NUMBER 	Запчасти
Инжектор CO-PJ- NUMBER G NUMBER -P NUMBER 	Запчасти
Ключ гаечный КГД  NUMBER х NUMBER 	Инструмент слесарный
Сейф Valberg	МатерСтроительные
Строп текст петл СТП- NUMBER , NUMBER / NUMBER 	Стропы
Сверло спиральное к/х  NUMBER , NUMBER 	Сверла
Датчик ЛИР- NUMBER - NUMBER - NUMBER - NUMBER - NUMBER -СН- NUMBER - NUMBER - NUMBER , NUMBER 	ДатчСистемАвтоматики
Корпус клапана  NUMBER . NUMBER - NUMBER - NUMBER  ТПЦ- NUMBER 	З/Ч по чертежам
Соединитель болт ГС- NUMBER  UGS- NUMBER - NUMBER KV-S	Запчасти
Манжета  NUMBER х NUMBER х NUMBER  HMSA NUMBER  RG SKF	ИзделияРезино-технич
Крышка ч.НР NUMBER . NUMBER . NUMBER . NUMBER 	Запчасти
Рейка В NUMBER  ТПЦ- NUMBER 	З/Ч по чертежам
Шкив ч.М- NUMBER - NUMBER 	Запчасти
Ключ трубный № NUMBER 	Инструменты
Крышка ч.Р- NUMBER 	Запчасти
Ремкомплект для насоса  NUMBER - NUMBER - NUMBER . NUMBER . NUMBER 	Запчасти
Картридж полноцветный YMCKO для Zebra	ВычОргТехн и З/Ч
Отвод  NUMBER град  NUMBER х NUMBER  ст NUMBER 	Металлопрокат
Фитинг С NUMBER  Norgren	З/Ч Пневмооборудов
Провод обмот ПСДКТ  NUMBER , NUMBER х NUMBER , NUMBER мм	Кабельно-проводников
Насос A NUMBER VSO NUMBER DR/ NUMBER R-VPA NUMBER N NUMBER 	Насосы
Ролик  NUMBER L NUMBER . NUMBER СБ ТПЦ- NUMBER 	З/Ч по чертежам
Муфта зубчатая  NUMBER L NUMBER СБ	З/Ч по чертежам
Комплект щеток стекл L- NUMBER   NUMBER  NISSAN  NUMBER ед	З/Ч АвтомобПромышл
Круг  NUMBER  стШХ NUMBER 	ПрокатСортовойОбНазн
Винт  NUMBER х NUMBER  ГОСТ NUMBER - NUMBER (DIN  NUMBER )	Метизы
Ремень вентилят  NUMBER х NUMBER х NUMBER 	ИзделияРезино-технич
Дюбель-гвоздь  NUMBER х NUMBER 	Метизы
Пластина резьбовая TI- NUMBER . NUMBER ER NUMBER - NUMBER . NUMBER BUH NUMBER D NUMBER 	Сплав твердый
Кирпич RI-MC NUMBER EC  NUMBER / NUMBER 	Огнеупоры
Кирпич периклазоуглерод RI-MC NUMBER LС  NUMBER / NUMBER 	Периклазоуглеродисты
Светильник светозаграждения ЗОЛ- NUMBER М	СветотехнИсточнСвета
Подшипник  NUMBER  ( NUMBER )	Подшипники
Крепление DS- NUMBER ZJ-PT NUMBER 	Запчасти
Стакан погружной  NUMBER -SES- NUMBER 	Спецогнеупоры
Диск FUJ CA NUMBER  E NUMBER  DX S NUMBER  HD  NUMBER GB  NUMBER K	Насосы
Термометр ИК Optris LS	КонтрИзмеритПриборы
Винт  NUMBER , NUMBER х NUMBER  А NUMBER  ГОСТ NUMBER - NUMBER (DIN NUMBER )	Метизы
Извещатель пожарный ИПР  NUMBER - NUMBER А исп. NUMBER 	ХозИнвентарь
Болт М NUMBER х NUMBER  ГОСТ NUMBER - NUMBER 	Метизы
Отвод  NUMBER - NUMBER - NUMBER , NUMBER х NUMBER , NUMBER  ст NUMBER 	Арматура к трубам
Уплотнение  NUMBER х NUMBER х NUMBER  DIN NUMBER  NBR	Метизы
Строп цепной  NUMBER СЦ- NUMBER , NUMBER тн/ NUMBER мм	Стропы
Наконечник-гильза Е NUMBER   NUMBER мм NUMBER 	Кабельная продукция
Сверло по бетону  NUMBER  хвостовик Т NUMBER 	Сверла
Дальномер лазерный Y NUMBER TA NUMBER QXT NUMBER  Wenglor	Инструм. мерительный
Комплект колонок Genius SP-S NUMBER   NUMBER ед	ВычОргТехн и З/Ч
Кольцо R NUMBER   NUMBER , NUMBER x NUMBER , NUMBER  Ecorubber- NUMBER 	Запчасти
Зажим проволочный К NUMBER У NUMBER 	Запчасти
Рукав нерж  NUMBER . NUMBER х NUMBER х NUMBER 	МетПродМашиностроен.
Зубило  NUMBER х NUMBER  мм	Инструмент слесарный
Гидрораспр.  NUMBER Р NUMBER -АЛ NUMBER - NUMBER  Г NUMBER 	Запчасти
Подшипник  NUMBER  Е/С NUMBER 	Подшипники
Ствол пожарный СРК- NUMBER 	ОборПожарныйИнвен
Винт самонарезающий  NUMBER , NUMBER х NUMBER  ГОСТ NUMBER - NUMBER 	Метизы
Резец проходной прямой  NUMBER х NUMBER  Т NUMBER К NUMBER 	Резцы
Звено соединительное С-ПР- NUMBER , NUMBER - NUMBER 	Метизы
Тягомер ТмМП- NUMBER -М NUMBER  - NUMBER , NUMBER - NUMBER  кПа	КонтрИзмеритПриборы
Болт М NUMBER Х NUMBER  ГОСТ NUMBER - NUMBER 	Метизы
Лента противоскользящая  NUMBER М  NUMBER ммх NUMBER м	Изделия электроустан
Комплект монт- NUMBER  (винт шайба гайка)  NUMBER шт	Метизы
Контактор  NUMBER RT NUMBER - NUMBER BB NUMBER 	Контакторы
Микрометр МК- NUMBER   NUMBER - NUMBER мм  NUMBER . NUMBER  кл NUMBER 	Инструменты
Набивка Графлекс НУ- NUMBER   NUMBER х NUMBER 	Издел.Асбесто-технич
Заглушка полиэтиленовая ф NUMBER , NUMBER х NUMBER , NUMBER 	ИздДляТрубПредохран
Манжета  NUMBER Л NUMBER   NUMBER х NUMBER х NUMBER  EcorubberТПЦ- NUMBER 	Запчасти
Круг  NUMBER  ст NUMBER Х NUMBER МФС	ПрокатСортовойОбНазн
Зажим стальной  NUMBER мм для троса оцинкован	Метизы
Винт М NUMBER х NUMBER   NUMBER . NUMBER 	Резцы
Коробка клем КСРВ-М NUMBER ( NUMBER CBC. NUMBER /GR)	Запчасти
Манжета B NUMBER   NUMBER x NUMBER x NUMBER  DIN NUMBER   NUMBER  NBR  NUMBER 	ИзделияРезино-технич
Кулачок  NUMBER . NUMBER . NUMBER . NUMBER А- NUMBER 	Резцы
Болт ч. NUMBER - NUMBER . NUMBER 	Запчасти
Баббит Б- NUMBER 	З/Ч по чертежам
Элемент воздушный  NUMBER   NUMBER  низ ЗМЗ- NUMBER 	З/Ч ТракСтроитТехн
Гидроцилиндр PD NUMBER . NUMBER . NUMBER  ТПЦ- NUMBER 	З/Ч Гидрооборудован
Гильза  NUMBER  ступени  NUMBER М NUMBER / NUMBER . NUMBER . NUMBER . NUMBER 	Запчасти
Вкладыш нижний бронз БТС NUMBER  М NUMBER . NUMBER  ТПЦ- NUMBER 	З/Ч по чертежам
Маркер кабельн МК NUMBER - NUMBER , NUMBER мм NUMBER  в упак по NUMBER шт	Изделия электроустан
Переключатель комбинир  NUMBER . NUMBER 	Запчасти
Подшипник  NUMBER АУ NUMBER 	Запчасти
Датчик давления DG  NUMBER U- NUMBER   NUMBER - NUMBER mbar	З/Ч Пневмооборудов
Кронштейн ч.Р- NUMBER - NUMBER 	Запчасти
Стол приставной-брифинг	Мебель
Фильтр салона Toyota Camry V NUMBER 	З/Ч АвтомобПромышл
Рукав РВД  NUMBER - NUMBER  (G- NUMBER / NUMBER )  NUMBER мм	ИзделияРезино-технич
Круг абразивный  NUMBER х NUMBER х NUMBER   NUMBER А	Инструменты
Шланг порошковый ПВХ ф NUMBER х NUMBER  ITW GEMA	Запчасти
Подшипник PCJT NUMBER -XL-N	Запчасти
Переход К- NUMBER х NUMBER - NUMBER х NUMBER  ст NUMBER 	Арматура к трубам
Втулка ч.К- NUMBER 	Запчасти
Место рабочее =BO NUMBER +РМ NUMBER 	Запчасти
Кислота соляная хч	Химпродукция
Втулка амортизатора ГАЗ- NUMBER 	З/Ч АвтомобПромышл
Шкив ф NUMBER хф NUMBER х NUMBER  ч. NUMBER . NUMBER - NUMBER 	Запчасти
Батарейка Panasonic CR  NUMBER  Lithium  NUMBER V	Запчасти
Кольцо уплот  NUMBER , NUMBER х NUMBER , NUMBER х NUMBER , NUMBER  Ф NUMBER С NUMBER 	Запчасти
'Фитинг ELBOW  NUMBER  SW  NUMBER   NUMBER '' A NUMBER F NUMBER L	Арматура к трубам
Гидромотор Г  NUMBER - NUMBER Р ТУ NUMBER - NUMBER - NUMBER - NUMBER 	Запчасти
Кран шаровый полипропиленовый Ф NUMBER 	ИздИзПолимеровСтанд
Аккум.мемб.HAD NUMBER , NUMBER - NUMBER - NUMBER X/ NUMBER G NUMBER C- NUMBER N NUMBER -ВА	Запчасти
Пирометр IGA  NUMBER  MB  NUMBER  IMPAC	КонтрИзмеритПриборы
Модуль  NUMBER SN NUMBER - NUMBER AA NUMBER - NUMBER KA NUMBER 	Запчасти
Головка щеточная  NUMBER . NUMBER . NUMBER - NUMBER СБ ТПЦ- NUMBER 	ИнстОснастТехнПоЧерт
Втулка ч. NUMBER - NUMBER / NUMBER 	Запчасти
Винт М NUMBER х NUMBER  ст NUMBER Х	Метизы
Кран двухсекционный  NUMBER  КАМАЗ	З/Ч АвтомобПромышл
Комплект креп болт с гай NUMBER -П NUMBER ГАЗЕЛЬ	Мебель
Ключ UEBERG-ST G NUMBER   NUMBER / NUMBER A-G NUMBER / NUMBER NBR/S NUMBER  Baug	ОборудПрочее
Уголок стальной  NUMBER х NUMBER х NUMBER  ст. NUMBER сп/пс	Металлопрокат
Подшипник  NUMBER АК NUMBER 	Запчасти
Компл рем зад ступ  NUMBER - NUMBER КАМАЗ NUMBER ед	З/Ч АвтомобПромышл
Пластина ч.Э- NUMBER - NUMBER - NUMBER 	Запчасти
Шпилька М NUMBER х NUMBER   NUMBER . NUMBER  DIN  NUMBER 	Метизы
Гайка М NUMBER  ГОСТ NUMBER - NUMBER  (DIN NUMBER )	Метизы
Фильтр салона RENAULT SANDERO	З/Ч АвтомобПромышл
Втулка бронз эскиз А- NUMBER  ТПЦ- NUMBER 	З/Ч по чертежам
Крышка головки щеточной  NUMBER . NUMBER . NUMBER 	ИнстОснастТехнПоЧерт
Колодка к реле CR M NUMBER   NUMBER ПК  NUMBER SVR NUMBER R NUMBER 	Реле
Кабель силовой гибкий КГ  NUMBER х NUMBER 	Кабельно-проводников
Флюс Metaflux	З/Ч Пневмооборудов
Уплотнение V-Ring VA- NUMBER  NBR	Запчасти
Вентилятор  NUMBER SN NUMBER - NUMBER BA NUMBER - NUMBER AA NUMBER 	Запчасти
Смазка Mobil Polyrex EM	Смазки
Миниканал TMR  NUMBER x NUMBER   NUMBER 	Кабельная продукция
Светильник НСР  NUMBER - NUMBER  IP NUMBER 	СветотехнИсточнСвета
Ремкомплект ГЦ от NUMBER х NUMBER х NUMBER х NUMBER  ЕК NUMBER   NUMBER ед	З/Ч ТракСтроитТехн
Лампа ДРВ  NUMBER 	Комплектующие электр
Грязесъемник АО NUMBER   NUMBER х NUMBER х NUMBER х NUMBER х NUMBER  Rub NUMBER 	ИздИзПолимерПоЧертеж
Шплинт  NUMBER , NUMBER х NUMBER  ГОСТ NUMBER - NUMBER 	Метизы
Подшипник  NUMBER - NUMBER 	Запчасти
Асбокартон КАОН- NUMBER   NUMBER мм	ОборудПрочее
Винт  NUMBER х NUMBER  А NUMBER  ГОСТ NUMBER - NUMBER (DIN NUMBER )	Метизы
Уплотн К NUMBER Н  NUMBER х NUMBER , NUMBER х NUMBER х NUMBER х NUMBER , NUMBER  Rub NUMBER /Flon	Запчасти
Заслонка пов. VAG EKN DN NUMBER  PN NUMBER  с э/пр	Запчасти
'Пара винтовая ШВП оси ''X''  NUMBER  EMAG	З/Ч кМеталлообОборуд
Кабель QLFLEХ NSHTQU-J  NUMBER х NUMBER  ар  NUMBER 	Кабельно-проводников
Бур к перфоратору SDS+  NUMBER х NUMBER / NUMBER 	Сверла
Кабель внутр компенсационный LC NUMBER 	Кабельная продукция
Фильтр сепаратор  NUMBER . NUMBER 	Запчасти
Вал-шестерня  NUMBER L NUMBER . NUMBER  ТПЦ- NUMBER 	З/Ч по чертежам
Шайба пружинная  NUMBER  А NUMBER  ГОСТ NUMBER - NUMBER (DIN NUMBER )	Метизы
Прокладка стальная RADEX-N  NUMBER  ST	З/Ч по чертежам
Метчик м/р М NUMBER х NUMBER , NUMBER 	Инструмент режущий
Стяжка монтажн кабельн  NUMBER , NUMBER х NUMBER мм	Изделия электроустан
Тележка направляющая R  NUMBER   NUMBER   NUMBER 	Запчасти
Метчик м/р М NUMBER х NUMBER , NUMBER  компл  NUMBER ед	Инструмент режущий
Головка BOR NUMBER E-SSCKCL NUMBER - NUMBER -X	Инструменты
Вентилятор ВКРС № NUMBER , NUMBER   NUMBER , NUMBER кВт  NUMBER об/мин	Запчасти
Подшипник  NUMBER  ( NUMBER  Z)	Подшипники
Подшипник  NUMBER  М	Запчасти
Экспандер  NUMBER . NUMBER . NUMBER Б- NUMBER  ТПЦ- NUMBER 	ИнстОснастТехнПоЧерт
Болт М NUMBER х NUMBER  ГОСТ NUMBER - NUMBER 	Метизы
Пластина тв спл N NUMBER . NUMBER - NUMBER - NUMBER E	Сплав твердый
Кабель OLFLEX CLASSIC  NUMBER   NUMBER х NUMBER , NUMBER   NUMBER 	Кабельная продукция
Уплот OMK-MR NUMBER x NUMBER , NUMBER x NUMBER , NUMBER   NUMBER 	ИздИзПолимерПоЧертеж
Клапан Z NUMBER S NUMBER - NUMBER - NUMBER x/	Запчасти
Гайка правая ч. NUMBER - NUMBER . NUMBER 	Запчасти
Эрихром черный Т чда	РеактивыХимич.
Кольцо R NUMBER   NUMBER x NUMBER  NBR	Запчасти
Конденсатор К NUMBER - NUMBER - NUMBER В- NUMBER мкФ- NUMBER %	Конденсаторы
Путь ч. NUMBER - NUMBER . NUMBER 	Запчасти
Преобразователь SG-KS- NUMBER - NUMBER  ALTHEN	ПриборыСистАвтоматик
Панель тип F РЗ. NUMBER . NUMBER . NUMBER . NUMBER - NUMBER  ЭСПЦ	ТехнологОборудЧертеж
Круг  NUMBER  ст NUMBER Х NUMBER М	ПрокатСортовойОбНазн
Тиски слесарные  NUMBER 	Инструмент слесарный
Свеча зажигания А- NUMBER ДВ- NUMBER 	З/Ч АвтомобПромышл
Переход  NUMBER . NUMBER х NUMBER . NUMBER / NUMBER  ETFE PN NUMBER 	Запчасти
Гидроруль У NUMBER   NUMBER / NUMBER . NUMBER  БЕЛАЗ	З/Ч ТракСтроитТехн
Шестигранник  NUMBER  ст NUMBER 	ПрокатСортовойОбНазн
Толщиномер Константа К NUMBER  с ИД NUMBER - NUMBER , NUMBER 	КонтрИзмеритПриборы
Потенциометр  NUMBER W- NUMBER K/ NUMBER ESA NUMBER W	КонтрИзмеритПриборы
Стол журнальный	Мебель
Клапан ч.Р- NUMBER 	Запчасти
Смесь сырьевых материалов ЭСП- NUMBER А	ХимПродОбщехимНазн
Саморез по металлу  NUMBER , NUMBER х NUMBER 	Метизы
Рукав кислородный III- NUMBER - NUMBER , NUMBER 	ИзделияРезино-технич
Редуктор JPSM NUMBER -P NUMBER C- NUMBER -WRC NUMBER 	Запчасти
Натрий бромистый	Химпродукция
Фреза шпоночная ц/х  NUMBER , NUMBER 	Фрезы
Ключ шестигранный  NUMBER 	Инструмент слесарный
Винт М NUMBER х NUMBER   NUMBER . NUMBER  ГОСТ NUMBER , DIN  NUMBER 	Метизы
Тройник ПВД  NUMBER * NUMBER * NUMBER 	Хоз.товары
Питатель двухлинейный VSG  NUMBER -KR	Запчасти
Элемент фильтр оч масл  NUMBER - NUMBER  КАМАЗ	З/Ч АвтомобПромышл
Реле  NUMBER RH NUMBER - NUMBER BM NUMBER  Siemens	Запчасти
Кассета А NUMBER 	Резцы
Болт М NUMBER х NUMBER  ГОСТ NUMBER - NUMBER 	Метизы
Болт М NUMBER х NUMBER   NUMBER . NUMBER  ГОСТ Р NUMBER - NUMBER 	Метизы
Втулка  NUMBER - NUMBER 	Резцы
Насос SB- NUMBER + NUMBER  BRINKMANN PUMPS	Насосы
Подушка радиатора ЗИЛ  NUMBER 	З/Ч АвтомобПромышл
Влагоотделитель с регулятор давл КАМАЗ	З/Ч АвтомобПромышл
Вкладыш ч.В- NUMBER - NUMBER - NUMBER - NUMBER ВО	Запчасти
Зажим клеммный  NUMBER мм NUMBER  JXB ИЭК	Изделия электроустан
Форсунка TradeTip NUMBER  пистолет GA NUMBER AL	ОборуТехнологическое
Стеклоподъемник универсальный ВАЗ  NUMBER 	З/Ч АвтомобПромышл
Подшипник шкворня упорный  NUMBER П ПАЗ	З/Ч АвтомобПромышл
ПЭП для УД- NUMBER  П NUMBER - NUMBER , NUMBER - NUMBER - NUMBER , NUMBER -ВМ- NUMBER 	Запчасти
Подшипник  NUMBER -J NUMBER AA-C NUMBER 	Подшипники
Ветошь х/б	Стройматериалы
Пластина т/с HM NUMBER  TPCR NUMBER PDFR-P IC NUMBER 	Сплав твердый
Пластина ч.Э- NUMBER - NUMBER - NUMBER 	Запчасти
Кабель ВВГ  NUMBER х NUMBER 	Кабельная продукция
Винт цил гол М NUMBER х NUMBER   NUMBER . NUMBER  DIN NUMBER 	Метизы
Тормоз ТКГ- NUMBER 	З/Ч ГрузПодъемОборуд
Вал ч.В- NUMBER - NUMBER - NUMBER 	Запчасти
Цилиндр CDM NUMBER  MP NUMBER   NUMBER / NUMBER / NUMBER  A NUMBER X/B NUMBER  CKDMWW	Запчасти
Ящик силовой ЯВЗ- NUMBER - NUMBER М- NUMBER -УХЛ NUMBER 	Запчасти
Блок продув PS- NUMBER /R NUMBER - NUMBER / NUMBER - NUMBER - NUMBER / NUMBER 	Огнеупоры
Рекуператор А  NUMBER - NUMBER 	З/Ч ТракСтроитТехн
Окись меди	Посуда и приборы хим
Клапан Z NUMBER DB NUMBER VA NUMBER - NUMBER X/ NUMBER V	З/Ч Гидрооборудован
Набивка сальниковая ВАТИ- NUMBER   NUMBER мм	ИздДляТрубПредохран
Шпонка  NUMBER х NUMBER х NUMBER  ГОСТ NUMBER - NUMBER 	Метизы
Пост сигнализации ПС В- NUMBER 	КнопкиПостыУправлен
Скотч канцелярский	Канцтовары
Модуль проц. NUMBER GK NUMBER - NUMBER EX NUMBER - NUMBER XE NUMBER 	Запчасти
Манжета полуоси  NUMBER - NUMBER х NUMBER - NUMBER  экс ЭО  NUMBER 	З/Ч ТракСтроитТехн
Батарея буферная  NUMBER FC NUMBER - NUMBER AA NUMBER - NUMBER AA NUMBER 	МодулПлатыСистАвтом
Горелка Pyrejet в сборе  NUMBER -NE NUMBER  ACI	Трубы
Ванадий пятиокись	Материалы вспом-е
Пластина тв спл  NUMBER  ВК NUMBER 	Сплав твердый
Автомат ВА NUMBER - NUMBER   NUMBER Р  NUMBER а	Запчасти
Подъемник ножничный ПП  NUMBER , NUMBER / NUMBER 	Инструменты
Сетка нержавеющая тканая  NUMBER , NUMBER х NUMBER , NUMBER 	Метизы
Гайка М NUMBER  А NUMBER  DIN NUMBER 	Метизы
Соединение быстроразъем КАМЛОК SSD- NUMBER 	Запчасти
Труба ПВДФ ф NUMBER x NUMBER , NUMBER  Ру NUMBER 	ИздИзПолимеровСтанд
Винт  NUMBER х NUMBER  ГОСТ NUMBER - NUMBER (DIN  NUMBER )	Метизы
Болт М NUMBER х NUMBER  А NUMBER  DIN  NUMBER  нерж	Метизы
Подшипник  NUMBER EK	Подшипники
Вал приводного колеса ч.М- NUMBER - NUMBER 	Запчасти
Электрод сварочный УОНИ- NUMBER / NUMBER  ф NUMBER 	Метизы
Сверло спиральное к/х  NUMBER , NUMBER 	Сверла
РВД  NUMBER - NUMBER -AOS/AOS-M NUMBER х NUMBER /M NUMBER х NUMBER - NUMBER 	Запчасти
Тормоз колодочный ТКГ- NUMBER 	Запчасти
Ниппель з/т ВС ф NUMBER , NUMBER мм	ИздДляТрубПредохран
Резец сборный XLCFN  NUMBER - NUMBER , NUMBER 	Резцы
'Переходник с  NUMBER / NUMBER '' на  NUMBER '' L= NUMBER мм USAG	Инструмент слесарный
Сумка брезентовая	Хоз.товары
Шина направляющая ч.М- NUMBER 	Запчасти
Подшипник  NUMBER CC/W NUMBER 	Подшипники
Груз на алюминиевый диск  NUMBER г	З/Ч АвтомобПромышл
Лапа ч.М NUMBER - NUMBER - NUMBER 	Запчасти
Аккумулятор  NUMBER в  NUMBER Ah для UPS	АккумБатареи и Элем
Фильтр в сборе BFD NUMBER  №  NUMBER 	Запчасти
Глинозем ГО	З/Ч ГрузПодъемОборуд
Промывалка п/э  NUMBER  с доп прям трубкой	Посуда и приборы хим
Подшипник INA GE NUMBER -FO- NUMBER RS	Запчасти
Реле ток. BA  NUMBER  DOLD&SOEHNE KG	З/Ч кМеталлообОборуд
Кран шаров  NUMBER Б NUMBER п NUMBER  Ду NUMBER  Ру NUMBER  амер вн/нар	АрматураТрубопровод
Диспенсер Aqua Work  NUMBER L (L/E, L/HL, L/D)	ОборудПрочее
Головка WMK- NUMBER . NUMBER - NUMBER - NUMBER - NUMBER   NUMBER  EMAG	Запчасти
Труба медная Ф NUMBER  для кристаллизатора	ИнстОснастТехнПоЧерт
Сверло спиральное ц/х  NUMBER , NUMBER  ВК NUMBER 	Сверла
Рукав нерж  NUMBER . NUMBER х NUMBER х NUMBER 	МетПродМашиностроен.
Ремкомплект насоса PV NUMBER  RK-PVBG NUMBER WPM NUMBER 	Запчасти
Отвертка крестовая  NUMBER  № NUMBER 	Инструмент слесарный
Фильтр плоский  NUMBER . NUMBER - NUMBER . NUMBER KARCHER NT NUMBER / NUMBER 	Запчасти
Планка латунная  NUMBER - NUMBER  ТПЦ- NUMBER 	З/Ч по чертежам
Клапан  NUMBER WE NUMBER J NUMBER X/EG NUMBER N NUMBER K NUMBER /V	Запчасти
Фланец  NUMBER - NUMBER - NUMBER 	АрматураТрубопровод
Пускатель ПМЛ  NUMBER  кат  NUMBER В  NUMBER А	Запчасти
'Головка торцовая  NUMBER -гранная  NUMBER / NUMBER ''  NUMBER мм	Инструмент слесарный
Сверло спиральное ц/х  NUMBER , NUMBER 	Сверла
Кабель HDMI - HDMI  NUMBER м	Кабельная продукция
Набор ключей торцевых  NUMBER  Gedore	Инструмент слесарный
Гидроцилиндр HY  NUMBER   NUMBER St. NUMBER C NUMBER 	З/Ч по чертежам
Бумага для плоттера формат А NUMBER (рулон)	ВычОргТехн и З/Ч
Отвертка Stayer компл  NUMBER пред	Инструмент слесарный
Фильтр  NUMBER ФГМ  NUMBER - NUMBER К	Запчасти
Винт  NUMBER х NUMBER  ГОСТ NUMBER - NUMBER (DIN  NUMBER )	Метизы
Винт  NUMBER х NUMBER  ГОСТ NUMBER - NUMBER (DIN NUMBER )	Метизы
Муфта DN  NUMBER - NUMBER  № NUMBER 	Запчасти
Рукав напорный В- NUMBER мм	ИзделияРезино-технич
Распределитель  NUMBER WE NUMBER D NUMBER / NUMBER AG NUMBER NETZ NUMBER L	Запчасти
РВД  NUMBER - NUMBER -AOL/AOL-M NUMBER x NUMBER , NUMBER /M NUMBER x NUMBER , NUMBER - NUMBER 	Запчасти
Шайба оси бокового ролика ч. NUMBER - NUMBER 	Запчасти
Болт М NUMBER х NUMBER 	Метизы
Фильтр рукавный ДСП ч.SN- NUMBER 	Запчасти
Станция смазочная  NUMBER - NUMBER 	Запчасти
Принтер Canon i-SENSYS LBP NUMBER dw	ВычОргТехн и З/Ч
Ролик HPV- NUMBER  OSBORN	З/Ч по чертежам
Подшипник МПЗ  NUMBER  ( NUMBER )	Подшипники
Шпилька оцинк. М NUMBER х NUMBER   NUMBER . NUMBER  DIN NUMBER 	Метизы
Гидроклапан LPFC-XHN	Запчасти
Выключатель  NUMBER RV NUMBER - NUMBER JA NUMBER  Siemens	Запчасти
Втулка зубчатая ч.В- NUMBER - NUMBER - NUMBER - NUMBER 	Запчасти
Траверса г/п  NUMBER тн	ОборуТехнологическое
Устройство USE NUMBER  U&S	З/Ч по чертежам
Датчик ВБИ-М NUMBER - NUMBER Р- NUMBER -З	Запчасти
Подшипник конич роликовый  NUMBER X	Подшипники
Ключ гаечный рожковый  NUMBER х NUMBER 	Инструменты
Фитинг  NUMBER С NUMBER - NUMBER - NUMBER 	Запчасти
Кольцо  NUMBER  Encore NORDSON	ОборуТехнологическое
Кабель OLFLEX CLASSIC  NUMBER  CY Black  NUMBER G NUMBER 	Кабельная продукция
Прокладка прие тр NUMBER - NUMBER УМЗ-А NUMBER ГАЗ	З/Ч АвтомобПромышл
Кольцо врезное FI-DS- NUMBER S-W NUMBER   NUMBER 	Арматура к трубам
Резец отрезной  NUMBER х NUMBER  ВК NUMBER 	Резцы
Строп стал канат УСК NUMBER - NUMBER , NUMBER / NUMBER 	Стропы
Раковина Тюльпан	Стройматериалы
Леска CHAMPION  NUMBER , NUMBER  мм	ХозИнвентарь
Плазмотрон А- NUMBER   NUMBER  метров Trafimet	ИнстОснастТехнПоЧерт
Аккумулятор  NUMBER АHзал бол ток пус от NUMBER А	Запчасти
Набор механика  NUMBER  Gedore	Инструмент слесарный
Синтофлекс  NUMBER  т  NUMBER , NUMBER мм	Электроизоляционные
Разъем  NUMBER   NUMBER A HAN	Изделия электроустан
Ключ гаечный КГД  NUMBER х NUMBER 	Инструмент слесарный
Фланец ч.Р- NUMBER 	Запчасти
Вал  NUMBER ст. ред.KS NUMBER - NUMBER S кл. NUMBER + ч. NUMBER 	ПриборыСистАвтоматик
Комплект упл. CD NUMBER B NUMBER / NUMBER Z NUMBER /IHFUMI- NUMBER 	Запчасти
Картридж гол для плот HP DSJT  NUMBER  крас NUMBER 	ВычОргТехн и З/Ч
Ключ шестигранный  NUMBER 	Инструмент слесарный
Обойма ч.В- NUMBER - NUMBER - NUMBER 	Запчасти
Муфта SPH  NUMBER / NUMBER /SP N NUMBER 	Запчасти
Контактор вак КВ  NUMBER , NUMBER - NUMBER , NUMBER / NUMBER - NUMBER  У NUMBER - NUMBER В	Запчасти
Плита дробящая подвижная ч.М- NUMBER 	Запчасти
Паронит ПОН  NUMBER , NUMBER 	Издел.Асбесто-технич
Хомут  NUMBER - NUMBER мм МТЗ Т- NUMBER  ЭО	З/Ч ТракСтроитТехн
Рукав резиновый напорный  NUMBER х NUMBER 	Запчасти
Дрель пневматическая  NUMBER 	Запчасти
Клапан с эл маг в сб NUMBER V  NUMBER . NUMBER   NUMBER 	З/Ч по чертежам
Подшипник GEH  NUMBER  ES- NUMBER RS	Запчасти
Круг отрезной  NUMBER х NUMBER х NUMBER   NUMBER С F NUMBER  R,S BF  NUMBER 	Инструм. абразивный
РВД  NUMBER - NUMBER -AOS/AOS-M NUMBER x NUMBER /M NUMBER x NUMBER - NUMBER 	Запчасти
Развертка коническая  NUMBER : NUMBER   NUMBER , NUMBER 	Инструмент режущий
Стеллаж металлический  NUMBER  полок	Мебель
Автомат ВА NUMBER - NUMBER   NUMBER Р  NUMBER а	Запчасти
Кабель HDMI to HDMI	Кабельная продукция
Комплект кол торм зад Skoda Octavia NUMBER   NUMBER ед	З/Ч АвтомобПромышл
Гидроцилиндр PD  NUMBER . NUMBER . NUMBER  Аgbor	Запчасти
Уплотнение ES  NUMBER х NUMBER х NUMBER   NUMBER 	ИздИзПолимерПоЧертеж
Тройник футер  NUMBER . NUMBER х NUMBER . NUMBER / NUMBER х NUMBER -ETFEкр	Метизы
Вышка строительная СП- NUMBER / NUMBER , NUMBER 	Метизы
Сэндвич-панель стеновая  NUMBER х NUMBER = NUMBER шт.	Стройматериалы
Смесь Accutherm ST-SP/ NUMBER - NUMBER - NUMBER 	Материалы вспом-е
Клапан DB NUMBER - NUMBER - NUMBER X/ NUMBER V	З/Ч Гидрооборудован
Винт попереч подачи в сборе к ст  NUMBER М NUMBER 	ПрокатЛистовойЛисты
Выключатель ВА NUMBER - NUMBER - NUMBER   NUMBER А  NUMBER В	Запчасти
Головка печ для трмтр принт Datamax  NUMBER 	КонтрИзмеритПриборы
Фреза отрезная  NUMBER х NUMBER , NUMBER 	Фрезы
Винт  NUMBER х NUMBER   NUMBER . NUMBER . DIN NUMBER 	Метизы
Маркер Memocad  NUMBER , NUMBER  мм  NUMBER  LEG  NUMBER 	Запчасти
Винт  NUMBER х NUMBER  ГОСТ NUMBER - NUMBER (DIN  NUMBER )	Метизы
Мера твердости МТВ HV NUMBER   NUMBER ± NUMBER   NUMBER разряд	Инструм. мерительный
Гвоздь строительный  NUMBER , NUMBER х NUMBER  ГОСТ  NUMBER - NUMBER 	Метизы
Протектор мет TMK UP TDSAMC NUMBER - NUMBER  прав	ИздДляТрубПредохран
Делитель потока МТО- NUMBER - NUMBER АVR Jahns	Запчасти
Раствор ремонтный SikaMonoTop- NUMBER N  NUMBER кг	Запчасти
Ножовка по дереву	Инструменты
Комплект свечей зажиг ГАЗ Газель  NUMBER ед	З/Ч АвтомобПромышл
Форсунка  NUMBER . NUMBER - NUMBER . NUMBER  Евро NUMBER  МТЗ NUMBER . NUMBER 	З/Ч ТракСтроитТехн
Сопло  NUMBER   NUMBER / NUMBER   NUMBER . NUMBER   NUMBER  Selmers	ОборуТехнологическое
Втулка резьб бронз  NUMBER . NUMBER - NUMBER - NUMBER  ТПЦ- NUMBER 	З/Ч по чертежам
Цепь А NUMBER - NUMBER х NUMBER 	Цепи и звенья
Заглушка полиэтиленовая ф NUMBER х NUMBER 	ИздДляТрубПредохран
Ковш КС- NUMBER  И- NUMBER . NUMBER . NUMBER СБ ЭСПЦ	ОборуТехнологическое
Реостат балластный РБ- NUMBER 	З/Ч к компрессорам
Сопло  NUMBER   NUMBER / NUMBER   NUMBER . NUMBER   NUMBER  Selmers	ОборуТехнологическое
Подшипник GE  NUMBER  ES SKF	Запчасти
Сетка AISI- NUMBER Б NUMBER х NUMBER х NUMBER , NUMBER х NUMBER 	З/Ч кМеталлообОборуд
Труба гладкая ПВХ ф NUMBER мм жесткая	Металлопрокат
Автомат А- NUMBER Б У NUMBER   NUMBER а  NUMBER в	ВыключатАвтоматич
Пластина тв спл RCMX  NUMBER MO CT NUMBER M	Сплав твердый
Амортизатор зад подв NUMBER   NUMBER КАМАЗ	З/Ч АвтомобПромышл
Дальномер лазерный Leica Disto X NUMBER 	Инструм. мерительный
Пуансон Ч.П- NUMBER - NUMBER  SMS DEMAG	Инструменты
Винт М NUMBER х NUMBER   NUMBER . NUMBER  ГОСТ NUMBER , DIN NUMBER 	Метизы
Кувалда  NUMBER кг	Инструмент слесарный
Наконечник кабельный  NUMBER мм NUMBER   NUMBER 	Изделия электроустан
Диметилглиоксим чда гост  NUMBER - NUMBER 	РеактивыХимич.
Втулка ч. NUMBER - NUMBER / NUMBER 	Запчасти
Блок контактов  NUMBER RH NUMBER - NUMBER GA NUMBER 	З/Ч ГрузПодъемОборуд
Пластина тв спл  NUMBER - NUMBER  PT NUMBER 	Сплав твердый
Круг  NUMBER  ст NUMBER 	ПрокатСортовойОбНазн
Подшипник  NUMBER А	Запчасти
Кабель HDMI  NUMBER м Fine Power	Кабельная продукция
Заглушка полиэтиленовая ф NUMBER , NUMBER х NUMBER , NUMBER 	ИздДляТрубПредохран
Кабель контрольн OLFLEX FD  NUMBER P  NUMBER х NUMBER , NUMBER 	Кабельно-проводников
Модуль вывода сигнала  NUMBER ES NUMBER - NUMBER BL NUMBER - NUMBER AA NUMBER 	МодулПлатыСистАвтом
Ложка  NUMBER . NUMBER . NUMBER А- NUMBER 	ИнстОснастТехнПоЧерт
Клапан обратный  NUMBER ч NUMBER бр Ду NUMBER 	Запчасти
Рама распорная  NUMBER х NUMBER х NUMBER  ч.Э- NUMBER 	Стройматериалы
Калий сернокислый хч	РеактивыХимич.
Плашка М NUMBER х NUMBER , NUMBER 	Инструмент режущий
Кронштейн кр оп кард/в NUMBER - NUMBER Газель	З/Ч АвтомобПромышл
Держатель с кр пр в сб NUMBER - NUMBER КАМАЗ	З/Ч АвтомобПромышл
Заглушка полиэтиленовая ф NUMBER , NUMBER х NUMBER , NUMBER 	ИздДляТрубПредохран
Кирпич периклазоуглерод RI-MC NUMBER LС  NUMBER / NUMBER 	Периклазоуглеродисты
Заглушка графитная кат.№ NUMBER  PICCARDI	Запчасти
Втулка ч.Э- NUMBER - NUMBER 	Запчасти
Кольцо типа О NBR NUMBER   NUMBER  Linsinger	Запчасти
Резистор предзаряда  NUMBER W NUMBER Om J	Запчасти
Болт М NUMBER х NUMBER  ГОСТ  NUMBER - NUMBER 	Метизы
Кирпич периклазоуглерод RI-MC- NUMBER LC№ NUMBER / NUMBER 	Периклазоуглеродисты
Шайба пружинная  NUMBER  оц DIN NUMBER 	Метизы
Сверло спиральное ц/х  NUMBER , NUMBER 	Сверла
Принтер лазерный HP LJ P NUMBER 	ВычОргТехн и З/Ч
Гидроцил. CDM NUMBER MF NUMBER   NUMBER / NUMBER / NUMBER A NUMBER X/B NUMBER CGDTWW	Запчасти
Муфта К- NUMBER 	Запчасти
Тройник быстроразъемный KQ NUMBER T NUMBER - NUMBER 	З/Ч Пневмооборудов
Распределитель DHA/RU- NUMBER PA-GK NUMBER DC Atos	З/Ч Гидрооборудован
Образец станд нефтепродукты в ЧХУ	РеактивыХимич.
Круг  NUMBER  ст NUMBER 	ПрокатСортовойОбНазн
Звено С- NUMBER B- NUMBER  ISO NUMBER /DIN NUMBER 	МетПродМашиностроен.
Пара плунжерн  NUMBER   NUMBER - NUMBER  КАМАЗ  NUMBER 	З/Ч АвтомобПромышл
Державка ч. NUMBER 	Инструменты
Втулка ч. NUMBER - NUMBER . NUMBER 	Запчасти
Пластина разделительная TS-RTK Ph NUMBER 	Изделия электроустан
Грунтовка Уникор РБ черная матовая	Электроизоляционные
Маркер  NUMBER  САВ NUMBER   NUMBER  зеленый  NUMBER , NUMBER - NUMBER , NUMBER мм NUMBER 	Изделия электроустан
Комплект прокладок КПП Камаз  NUMBER   NUMBER ед	З/Ч АвтомобПромышл
Направляющая В NUMBER  ТПЦ- NUMBER 	З/Ч по чертежам
Датчик положения  NUMBER ХР  NUMBER - NUMBER 	ДатчСистемАвтоматики
Винт попереч подачи с гайкой  NUMBER К NUMBER - NUMBER - NUMBER 	З/Ч кМеталлообОборуд
Шлифполотно объемное бобина  NUMBER ммх NUMBER м	Электроизоляционные
Пружина для креплен клейм символа  NUMBER 	З/Ч по чертежам
Фреза пазовая  NUMBER х NUMBER 	Фрезы
Кран шаров муфт  NUMBER Б NUMBER п NUMBER  Ду NUMBER  Ру NUMBER 	АрматураТрубопровод
Карта памяти  NUMBER G TS NUMBER GUSDU NUMBER  Transend	КонтрИзмеритПриборы
Электрогидротолкатель EB  NUMBER \ NUMBER  C NUMBER   NUMBER V	Запчасти
Рукав нерж  NUMBER . NUMBER х NUMBER х NUMBER 	МетПродМашиностроен.
Насос пластинч НПлР NUMBER / NUMBER , NUMBER 	Насосы
Муфта опер впрыска  NUMBER  КАМАЗ	З/Ч АвтомобПромышл
Колесо крановое ф NUMBER  ч. NUMBER 	Запчасти
Привод бендикса  NUMBER . NUMBER  трактор Т  NUMBER 	З/Ч ТракСтроитТехн
Подшипник  NUMBER  ( NUMBER - NUMBER Z)	Подшипники
Гайка М NUMBER  ГОСТ NUMBER - NUMBER 	Метизы
Винт  NUMBER х NUMBER  ГОСТ NUMBER - NUMBER (DIN  NUMBER )	Метизы
Реле врем  NUMBER RP NUMBER - NUMBER AP NUMBER   NUMBER , NUMBER - NUMBER сек	Реле
"Штуцер под форсунку  NUMBER   NUMBER / NUMBER "" НР NUMBER "	ОборудПрочее
Кран пробк муфт  NUMBER Б NUMBER бк Ду NUMBER  Ру NUMBER 	АрматураТрубопровод
Канат ZnВ-zs-H-P NUMBER мс  NUMBER хk NUMBER WS-IWRS  NUMBER , NUMBER 	Метизы
Кран обратного действия  NUMBER  КАМАЗ	З/Ч АвтомобПромышл
Ролик ч.Р- NUMBER 	Запчасти
Блок цилиндров ч NUMBER  POS  NUMBER  SMS	Запчасти
Сульфат алюминия	ИздИзПолимеровСтанд
Привод HDUA- NUMBER - NUMBER -BLS-SP Harmonic	Метизы
Кирпич  NUMBER / NUMBER  RI-AMC NUMBER LC	Огнеупоры
Насос вакуумный КО- NUMBER . NUMBER . NUMBER . NUMBER  КО- NUMBER 	Насосы
Пластина резьбовая TN  NUMBER ER  NUMBER M-Р NUMBER   NUMBER 	Сплав твердый
Болт М NUMBER  ч.Р- NUMBER 	Запчасти
Кирпич ANCARBON CN NUMBER   NUMBER / NUMBER 	Огнеупоры
Реагент НАЛКО  NUMBER 	ХимПродОбщехимНазн
Уплотнение A NUMBER -A  NUMBER х NUMBER , NUMBER х NUMBER , NUMBER x NUMBER  PUR	Запчасти
Щит ЩРН- NUMBER з- NUMBER - NUMBER 	Запчасти
Втулка ч.НР NUMBER . NUMBER . NUMBER . NUMBER 	Запчасти
Выключатель авт. ВА NUMBER - NUMBER   NUMBER Р  NUMBER а	Запчасти
Карман ч. NUMBER - NUMBER . NUMBER . NUMBER . NUMBER . NUMBER СБ	Запчасти
Крышка  NUMBER L NUMBER . NUMBER  ТПЦ- NUMBER 	З/Ч по чертежам
Кувалда  NUMBER кг	Инструмент слесарный
Насос WILO TOP-S  NUMBER / NUMBER 	Запчасти
Труба гофрированная ф NUMBER - NUMBER 	Стройматериалы
Подшипник  NUMBER  ( NUMBER )	Подшипники
Сверло спиральное ц/х  NUMBER , NUMBER 	Сверла
Рама распорная  NUMBER х NUMBER х NUMBER  ч.Э- NUMBER 	Стройматериалы
Вал выходнойч. Э- NUMBER - NUMBER 	Запчасти
Мембрана  NUMBER  DIABON DN NUMBER  SGL	З/Ч Пневмооборудов
Рукав пожарн ф NUMBER мм  NUMBER м в сборе с ГР- NUMBER 	ОборПожарныйИнвен
Углошлифмашина УШМ- NUMBER / NUMBER Э  NUMBER , NUMBER кВт	ОборудПрочее
Ключ гаечный рожковый  NUMBER 	Инструменты
Кабель OPVC-JZ  NUMBER G NUMBER , NUMBER 	Кабельная продукция
Зажим SPAL  NUMBER , NUMBER  PP-DPAL-AS M W NUMBER 	З/Ч по чертежам
Винт М NUMBER х NUMBER   NUMBER . NUMBER  ГОСТ NUMBER - NUMBER , DIN  NUMBER 	Метизы
Брус резинокомпозитный  NUMBER х NUMBER х NUMBER мм	ИздДляТрубПредохран
Пресс ручной гидрав ПГР- NUMBER 	ОборуТехнологическое
Стяжка монтажн кабельн  NUMBER , NUMBER х NUMBER мм	Изделия электроустан
Разъем DB- NUMBER F	ПриборыСистАвтоматик
Уплотнение OMS-MR  NUMBER х NUMBER , NUMBER х NUMBER , NUMBER   NUMBER 	ИздИзПолимерПоЧертеж
Подшипник NNU  NUMBER B/SPC NUMBER W NUMBER 	Подшипники
Соединитель проходной G NUMBER LCF	Запчасти
Бумага XEROX Colotech  NUMBER г А NUMBER   NUMBER  листов	ПродукцЦеллюлозБумаж
Уплотнение S NUMBER -P  NUMBER x NUMBER , NUMBER x NUMBER , NUMBER  Ecopur/NBR	ИздИзПолимерПоЧертеж
Сверло спиральное к/х  NUMBER , NUMBER 	Сверла
Уплотнение R NUMBER -R  NUMBER х NUMBER х NUMBER  Ecorubber- NUMBER 	ИздИзПолимерПоЧертеж
Кольцо R NUMBER   NUMBER х NUMBER , NUMBER  NBR	Запчасти
Кран переливной SP-CART-M NUMBER / NUMBER  Atos	З/Ч Гидрооборудован
Смесь шлакообразующая Forward IGM/TN	Материалы вспом-е
Хомут ч.М- NUMBER - NUMBER  ст NUMBER Х NUMBER 	Запчасти
Ключ гаечный кольцевой коленч КГН  NUMBER х NUMBER 	Инструмент слесарный
Бумага ALBEO  NUMBER x NUMBER 	Канцтовары
Распределитель MFH- NUMBER / NUMBER -D- NUMBER -C	З/Ч Пневмооборудов
Уплотнение торцовое СР. NUMBER . NUMBER . NUMBER  КК	Запчасти
Лейка к смесителю для душа	Стройматериалы
Опора полипропиленовая PPR ф NUMBER 	ИздИзПолимеровСтанд
Рессора зад  NUMBER л  NUMBER - NUMBER - NUMBER  в сб ЗИЛ	З/Ч АвтомобПромышл
Подшипник  NUMBER - NUMBER С NUMBER 	Запчасти
Втулка ч. NUMBER - NUMBER . NUMBER 	Запчасти
Фильтроэлемент  NUMBER R NUMBER BN NUMBER HC	Запчасти
Пила цепная электр руч UC  NUMBER А Makita	Инстр. электрический
Картридж Canon PFI- NUMBER C голубой  NUMBER  мл	ВычОргТехн и З/Ч
Бокс модульный КМПн- NUMBER  ИЭК	ДиодТранзисторТирист
